PokerStars Zoom Hand #257879890889:  Hold'em No Limit ($0.02/$0.05) - 2025/09/25 19:16:01 JST [2025/09/25 6:16:01 ET]
Table 'Donati' 6-max Seat #1 is the button
Seat 1: huyjokezy ($5 in chips) 
Seat 2: BrickByBrick68 ($17.53 in chips) 
Seat 3: FakaN4Kavera ($5 in chips) 
Seat 4: hatater ($6.16 in chips) 
Seat 5: Woidprophet ($6.50 in chips) 
Seat 6: intentii ($5.34 in chips) 
BrickByBrick68: posts small blind $0.02
FakaN4Kavera: posts big blind $0.05
*** HOLE CARDS ***
Dealt to FakaN4Kavera [Jc 9h]
hatater: folds 
Woidprophet: folds 
intentii: folds 
huyjokezy: folds 
BrickByBrick68: folds 
Uncalled bet ($0.03) returned to FakaN4Kavera
FakaN4Kavera collected $0.04 from pot
FakaN4Kavera: doesn't show hand 
*** SUMMARY ***
Total pot $0.04 | Rake $0 
Seat 1: huyjokezy (button) folded before Flop (didn't bet)
Seat 2: BrickByBrick68 (small blind) folded before Flop
Seat 3: FakaN4Kavera (big blind) collected ($0.04)
Seat 4: hatater folded before Flop (didn't bet)
Seat 5: Woidprophet folded before Flop (didn't bet)
Seat 6: intentii folded before Flop (didn't bet)



PokerStars Zoom Hand #257879892170:  Hold'em No Limit ($0.02/$0.05) - 2025/09/25 19:16:15 JST [2025/09/25 6:16:15 ET]
Table 'Donati' 6-max Seat #1 is the button
Seat 1: KRSofM ($6.20 in chips) 
Seat 2: FakaN4Kavera ($5.02 in chips) 
Seat 3: 1Kronos ($14.84 in chips) 
Seat 4: tekkita ($3.30 in chips) 
Seat 5: YAG5292 ($8.68 in chips) 
Seat 6: Baikasas ($5.19 in chips) 
FakaN4Kavera: posts small blind $0.02
1Kronos: posts big blind $0.05
*** HOLE CARDS ***
Dealt to FakaN4Kavera [5c 2d]
tekkita: folds 
YAG5292: raises $0.10 to $0.15
Baikasas: folds 
KRSofM: folds 
FakaN4Kavera: folds 
1Kronos: folds 
Uncalled bet ($0.10) returned to YAG5292
YAG5292 collected $0.12 from pot
YAG5292: doesn't show hand 
*** SUMMARY ***
Total pot $0.12 | Rake $0 
Seat 1: KRSofM (button) folded before Flop (didn't bet)
Seat 2: FakaN4Kavera (small blind) folded before Flop
Seat 3: 1Kronos (big blind) folded before Flop
Seat 4: tekkita folded before Flop (didn't bet)
Seat 5: YAG5292 collected ($0.12)
Seat 6: Baikasas folded before Flop (didn't bet)



PokerStars Zoom Hand #257879892655:  Hold'em No Limit ($0.02/$0.05) - 2025/09/25 19:16:20 JST [2025/09/25 6:16:20 ET]
Table 'Donati' 6-max Seat #1 is the button
Seat 1: tekkita ($3.30 in chips) 
Seat 2: P0KER_GR1ND ($5.25 in chips) 
Seat 3: ElBrato421 ($5.06 in chips) 
Seat 4: Southpaw1331 ($3.02 in chips) 
Seat 5: BretticusX ($5.85 in chips) 
Seat 6: FakaN4Kavera ($5 in chips) 
P0KER_GR1ND: posts small blind $0.02
ElBrato421: posts big blind $0.05
*** HOLE CARDS ***
Dealt to FakaN4Kavera [Qc 4s]
Southpaw1331: raises $0.05 to $0.10
BretticusX: folds 
FakaN4Kavera: folds 
tekkita: folds 
P0KER_GR1ND: calls $0.08
ElBrato421: folds 
*** FLOP *** [7d 9s Qs]
P0KER_GR1ND: checks 
Southpaw1331: checks 
*** TURN *** [7d 9s Qs] [7s]
P0KER_GR1ND: checks 
Southpaw1331: bets $0.12
P0KER_GR1ND: folds 
Uncalled bet ($0.12) returned to Southpaw1331
Southpaw1331 collected $0.24 from pot
Southpaw1331: doesn't show hand 
*** SUMMARY ***
Total pot $0.25 | Rake $0.01 
Board [7d 9s Qs 7s]
Seat 1: tekkita (button) folded before Flop (didn't bet)
Seat 2: P0KER_GR1ND (small blind) folded on the Turn
Seat 3: ElBrato421 (big blind) folded before Flop
Seat 4: Southpaw1331 collected ($0.24)
Seat 5: BretticusX folded before Flop (didn't bet)
Seat 6: FakaN4Kavera folded before Flop (didn't bet)



PokerStars Zoom Hand #257879893621:  Hold'em No Limit ($0.02/$0.05) - 2025/09/25 19:16:30 JST [2025/09/25 6:16:30 ET]
Table 'Donati' 6-max Seat #1 is the button
Seat 1: Woidprophet ($6.58 in chips) 
Seat 2: intentii ($5.29 in chips) 
Seat 3: zodapoker ($5 in chips) 
Seat 4: serg430606 ($3.30 in chips) 
Seat 5: FakaN4Kavera ($5 in chips) 
Seat 6: huyjokezy ($5 in chips) 
intentii: posts small blind $0.02
zodapoker: posts big blind $0.05
*** HOLE CARDS ***
Dealt to FakaN4Kavera [Ah Js]
serg430606: folds 
FakaN4Kavera: raises $0.07 to $0.12
huyjokezy: folds 
Woidprophet: folds 
intentii: folds 
zodapoker: raises $0.36 to $0.48
FakaN4Kavera: folds 
Uncalled bet ($0.36) returned to zodapoker
zodapoker collected $0.26 from pot
zodapoker: doesn't show hand 
*** SUMMARY ***
Total pot $0.26 | Rake $0 
Seat 1: Woidprophet (button) folded before Flop (didn't bet)
Seat 2: intentii (small blind) folded before Flop
Seat 3: zodapoker (big blind) collected ($0.26)
Seat 4: serg430606 folded before Flop (didn't bet)
Seat 5: FakaN4Kavera folded before Flop
Seat 6: huyjokezy folded before Flop (didn't bet)



PokerStars Zoom Hand #257879893250:  Hold'em No Limit ($0.02/$0.05) - 2025/09/25 19:16:26 JST [2025/09/25 6:16:26 ET]
Table 'Donati' 6-max Seat #1 is the button
Seat 1: FakaN4Kavera ($5 in chips) 
Seat 2: _jay_44_jas ($5.09 in chips) 
Seat 3: Kenzo2211 ($5.20 in chips) 
Seat 4: gm__701 ($6.58 in chips) 
Seat 5: 1Kronos ($14.79 in chips) 
Seat 6: franks270 ($7.60 in chips) 
_jay_44_jas: posts small blind $0.02
Kenzo2211: posts big blind $0.05
*** HOLE CARDS ***
Dealt to FakaN4Kavera [2d 5h]
gm__701: folds 
1Kronos: folds 
franks270: calls $0.05
FakaN4Kavera: folds 
_jay_44_jas: folds 
Kenzo2211: checks 
*** FLOP *** [6h 7h 8d]
Kenzo2211: checks 
franks270: bets $0.05
Kenzo2211: calls $0.05
*** TURN *** [6h 7h 8d] [3h]
Kenzo2211: checks 
franks270: bets $0.05
Kenzo2211: calls $0.05
*** RIVER *** [6h 7h 8d 3h] [As]
Kenzo2211: checks 
franks270: bets $0.05
Kenzo2211: calls $0.05
*** SHOW DOWN ***
franks270: shows [7s 8h] (two pair, Eights and Sevens)
Kenzo2211: mucks hand 
franks270 collected $0.40 from pot
*** SUMMARY ***
Total pot $0.42 | Rake $0.02 
Board [6h 7h 8d 3h As]
Seat 1: FakaN4Kavera (button) folded before Flop (didn't bet)
Seat 2: _jay_44_jas (small blind) folded before Flop
Seat 3: Kenzo2211 (big blind) mucked [8c Qs]
Seat 4: gm__701 folded before Flop (didn't bet)
Seat 5: 1Kronos folded before Flop (didn't bet)
Seat 6: franks270 showed [7s 8h] and won ($0.40) with two pair, Eights and Sevens



PokerStars Zoom Hand #257879896318:  Hold'em No Limit ($0.02/$0.05) - 2025/09/25 19:16:59 JST [2025/09/25 6:16:59 ET]
Table 'Donati' 6-max Seat #1 is the button
Seat 1: kmc4444 ($6.04 in chips) 
Seat 2: FakaN4Kavera ($5 in chips) 
Seat 3: huyjokezy ($5.07 in chips) 
Seat 4: leakleakA ($9.16 in chips) 
Seat 5: gio119 ($5 in chips) 
Seat 6: gm__701 ($5.23 in chips) 
FakaN4Kavera: posts small blind $0.02
huyjokezy: posts big blind $0.05
*** HOLE CARDS ***
Dealt to FakaN4Kavera [7h 9d]
leakleakA: raises $0.05 to $0.10
gio119: folds 
gm__701: folds 
kmc4444: folds 
FakaN4Kavera: folds 
huyjokezy: folds 
Uncalled bet ($0.05) returned to leakleakA
leakleakA collected $0.12 from pot
leakleakA: doesn't show hand 
*** SUMMARY ***
Total pot $0.12 | Rake $0 
Seat 1: kmc4444 (button) folded before Flop (didn't bet)
Seat 2: FakaN4Kavera (small blind) folded before Flop
Seat 3: huyjokezy (big blind) folded before Flop
Seat 4: leakleakA collected ($0.12)
Seat 5: gio119 folded before Flop (didn't bet)
Seat 6: gm__701 folded before Flop (didn't bet)



PokerStars Zoom Hand #257879897523:  Hold'em No Limit ($0.02/$0.05) - 2025/09/25 19:17:12 JST [2025/09/25 6:17:12 ET]
Table 'Donati' 6-max Seat #1 is the button
Seat 1: FakaN4Kavera ($5 in chips) 
Seat 2: KRSofM ($5.07 in chips) 
Seat 3: lebifflemaster ($7.63 in chips) 
Seat 4: faithfulness ($5 in chips) 
Seat 5: hatater ($5 in chips) 
Seat 6: elmex886 ($5 in chips) 
KRSofM: posts small blind $0.02
lebifflemaster: posts big blind $0.05
*** HOLE CARDS ***
Dealt to FakaN4Kavera [6h Qh]
faithfulness: folds 
hatater: folds 
elmex886: folds 
FakaN4Kavera: raises $0.07 to $0.12
KRSofM: folds 
lebifflemaster: calls $0.07
*** FLOP *** [3s 7d Td]
lebifflemaster: checks 
FakaN4Kavera: checks 
*** TURN *** [3s 7d Td] [As]
lebifflemaster: checks 
FakaN4Kavera: checks 
*** RIVER *** [3s 7d Td As] [Qd]
lebifflemaster: bets $0.19
FakaN4Kavera: folds 
Uncalled bet ($0.19) returned to lebifflemaster
lebifflemaster collected $0.25 from pot
lebifflemaster: doesn't show hand 
*** SUMMARY ***
Total pot $0.26 | Rake $0.01 
Board [3s 7d Td As Qd]
Seat 1: FakaN4Kavera (button) folded on the River
Seat 2: KRSofM (small blind) folded before Flop
Seat 3: lebifflemaster (big blind) collected ($0.25)
Seat 4: faithfulness folded before Flop (didn't bet)
Seat 5: hatater folded before Flop (didn't bet)
Seat 6: elmex886 folded before Flop (didn't bet)



PokerStars Zoom Hand #257879901673:  Hold'em No Limit ($0.02/$0.05) - 2025/09/25 19:17:56 JST [2025/09/25 6:17:56 ET]
Table 'Donati' 6-max Seat #1 is the button
Seat 1: tekkita ($2.51 in chips) 
Seat 2: intentii ($5 in chips) 
Seat 3: KRSofM ($6.25 in chips) 
Seat 4: hatater ($5.94 in chips) 
Seat 5: FakaN4Kavera ($5 in chips) 
Seat 6: Woidprophet ($7.37 in chips) 
intentii: posts small blind $0.02
KRSofM: posts big blind $0.05
*** HOLE CARDS ***
Dealt to FakaN4Kavera [As 9c]
hatater: folds 
FakaN4Kavera: folds 
Woidprophet: folds 
tekkita: folds 
intentii: folds 
Uncalled bet ($0.03) returned to KRSofM
KRSofM collected $0.04 from pot
KRSofM: doesn't show hand 
*** SUMMARY ***
Total pot $0.04 | Rake $0 
Seat 1: tekkita (button) folded before Flop (didn't bet)
Seat 2: intentii (small blind) folded before Flop
Seat 3: KRSofM (big blind) collected ($0.04)
Seat 4: hatater folded before Flop (didn't bet)
Seat 5: FakaN4Kavera folded before Flop (didn't bet)
Seat 6: Woidprophet folded before Flop (didn't bet)



PokerStars Zoom Hand #257879902181:  Hold'em No Limit ($0.02/$0.05) - 2025/09/25 19:18:01 JST [2025/09/25 6:18:01 ET]
Table 'Donati' 6-max Seat #1 is the button
Seat 1: ElBrato421 ($5.17 in chips) 
Seat 2: KRSofM ($5.01 in chips) 
Seat 3: FakaN4Kavera ($5 in chips) 
Seat 4: Woidprophet ($7.37 in chips) 
Seat 5: tekkita ($2.51 in chips) 
Seat 6: Ingyeoking ($5.08 in chips) 
KRSofM: posts small blind $0.02
FakaN4Kavera: posts big blind $0.05
*** HOLE CARDS ***
Dealt to FakaN4Kavera [Qd Td]
Woidprophet: folds 
tekkita: raises $0.07 to $0.12
Ingyeoking: folds 
ElBrato421: calls $0.12
KRSofM: folds 
FakaN4Kavera: calls $0.07
*** FLOP *** [2c Th Tc]
FakaN4Kavera: checks 
tekkita: bets $0.36
ElBrato421: calls $0.36
FakaN4Kavera: calls $0.36
*** TURN *** [2c Th Tc] [Qh]
FakaN4Kavera: checks 
tekkita: bets $2.03 and is all-in
ElBrato421: folds 
FakaN4Kavera: calls $2.03
*** RIVER *** [2c Th Tc Qh] [3s]
*** SHOW DOWN ***
FakaN4Kavera: shows [Qd Td] (a full house, Tens full of Queens)
tekkita: shows [Ks Kh] (two pair, Kings and Tens)
FakaN4Kavera collected $5.29 from pot
*** SUMMARY ***
Total pot $5.52 | Rake $0.23 
Board [2c Th Tc Qh 3s]
Seat 1: ElBrato421 (button) folded on the Turn
Seat 2: KRSofM (small blind) folded before Flop
Seat 3: FakaN4Kavera (big blind) showed [Qd Td] and won ($5.29) with a full house, Tens full of Queens
Seat 4: Woidprophet folded before Flop (didn't bet)
Seat 5: tekkita showed [Ks Kh] and lost with two pair, Kings and Tens
Seat 6: Ingyeoking folded before Flop (didn't bet)



PokerStars Zoom Hand #257879906984:  Hold'em No Limit ($0.02/$0.05) - 2025/09/25 19:18:52 JST [2025/09/25 6:18:52 ET]
Table 'Donati' 6-max Seat #1 is the button
Seat 1: YAG5292 ($8.63 in chips) 
Seat 2: FakaN4Kavera ($7.78 in chips) 
Seat 3: delfinato200 ($13.95 in chips) 
Seat 4: kmc4444 ($6.22 in chips) 
Seat 5: intentii ($5.07 in chips) 
Seat 6: ElBrato421 ($4.62 in chips) 
FakaN4Kavera: posts small blind $0.02
delfinato200: posts big blind $0.05
*** HOLE CARDS ***
Dealt to FakaN4Kavera [Jd Qs]
kmc4444: folds 
intentii: folds 
ElBrato421: folds 
YAG5292: folds 
FakaN4Kavera: raises $0.07 to $0.12
delfinato200: folds 
Uncalled bet ($0.07) returned to FakaN4Kavera
FakaN4Kavera collected $0.10 from pot
FakaN4Kavera: doesn't show hand 
*** SUMMARY ***
Total pot $0.10 | Rake $0 
Seat 1: YAG5292 (button) folded before Flop (didn't bet)
Seat 2: FakaN4Kavera (small blind) collected ($0.10)
Seat 3: delfinato200 (big blind) folded before Flop
Seat 4: kmc4444 folded before Flop (didn't bet)
Seat 5: intentii folded before Flop (didn't bet)
Seat 6: ElBrato421 folded before Flop (didn't bet)



PokerStars Zoom Hand #257879906122:  Hold'em No Limit ($0.02/$0.05) - 2025/09/25 19:18:43 JST [2025/09/25 6:18:43 ET]
Table 'Donati' 6-max Seat #1 is the button
Seat 1: 1Kronos ($10.12 in chips) 
Seat 2: KRSofM ($4.57 in chips) 
Seat 3: lebifflemaster ($7.88 in chips) 
Seat 4: gio119 ($5.19 in chips) 
Seat 5: zodapoker ($5.30 in chips) 
Seat 6: FakaN4Kavera ($7.78 in chips) 
KRSofM: posts small blind $0.02
lebifflemaster: posts big blind $0.05
*** HOLE CARDS ***
Dealt to FakaN4Kavera [7h Ac]
gio119: folds 
zodapoker: folds 
FakaN4Kavera: folds 
1Kronos: raises $0.05 to $0.10
KRSofM: raises $0.40 to $0.50
lebifflemaster: folds 
1Kronos: folds 
Uncalled bet ($0.40) returned to KRSofM
KRSofM collected $0.25 from pot
KRSofM: doesn't show hand 
*** SUMMARY ***
Total pot $0.25 | Rake $0 
Seat 1: 1Kronos (button) folded before Flop
Seat 2: KRSofM (small blind) collected ($0.25)
Seat 3: lebifflemaster (big blind) folded before Flop
Seat 4: gio119 folded before Flop (didn't bet)
Seat 5: zodapoker folded before Flop (didn't bet)
Seat 6: FakaN4Kavera folded before Flop (didn't bet)



PokerStars Zoom Hand #257879909191:  Hold'em No Limit ($0.02/$0.05) - 2025/09/25 19:19:15 JST [2025/09/25 6:19:15 ET]
Table 'Donati' 6-max Seat #1 is the button
Seat 1: FakaN4Kavera ($7.83 in chips) 
Seat 2: _jay_44_jas ($5.62 in chips) 
Seat 3: koshchey_a ($4.82 in chips) 
Seat 4: KRSofM ($4.72 in chips) 
Seat 5: delfinato200 ($13.88 in chips) 
Seat 6: Ingyeoking ($4.96 in chips) 
_jay_44_jas: posts small blind $0.02
koshchey_a: posts big blind $0.05
*** HOLE CARDS ***
Dealt to FakaN4Kavera [Td Jc]
KRSofM: folds 
delfinato200: folds 
Ingyeoking: folds 
FakaN4Kavera: raises $0.07 to $0.12
_jay_44_jas: folds 
koshchey_a: raises $0.31 to $0.43
FakaN4Kavera: folds 
Uncalled bet ($0.31) returned to koshchey_a
koshchey_a collected $0.26 from pot
koshchey_a: doesn't show hand 
*** SUMMARY ***
Total pot $0.26 | Rake $0 
Seat 1: FakaN4Kavera (button) folded before Flop
Seat 2: _jay_44_jas (small blind) folded before Flop
Seat 3: koshchey_a (big blind) collected ($0.26)
Seat 4: KRSofM folded before Flop (didn't bet)
Seat 5: delfinato200 folded before Flop (didn't bet)
Seat 6: Ingyeoking folded before Flop (didn't bet)



PokerStars Zoom Hand #257879912305:  Hold'em No Limit ($0.02/$0.05) - 2025/09/25 19:19:48 JST [2025/09/25 6:19:48 ET]
Table 'Donati' 6-max Seat #1 is the button
Seat 1: snake oil 12 ($5.50 in chips) 
Seat 2: Woidprophet ($6.44 in chips) 
Seat 3: intentii ($5.21 in chips) 
Seat 4: FakaN4Kavera ($7.71 in chips) 
Seat 5: kalopara ($29.63 in chips) 
Seat 6: egoor199 ($5.89 in chips) 
Woidprophet: posts small blind $0.02
intentii: posts big blind $0.05
*** HOLE CARDS ***
Dealt to FakaN4Kavera [9s Ts]
FakaN4Kavera: raises $0.07 to $0.12
kalopara: folds 
egoor199: raises $0.26 to $0.38
snake oil 12: folds 
Woidprophet: folds 
intentii: folds 
FakaN4Kavera: folds 
Uncalled bet ($0.26) returned to egoor199
egoor199 collected $0.31 from pot
egoor199: doesn't show hand 
*** SUMMARY ***
Total pot $0.31 | Rake $0 
Seat 1: snake oil 12 (button) folded before Flop (didn't bet)
Seat 2: Woidprophet (small blind) folded before Flop
Seat 3: intentii (big blind) folded before Flop
Seat 4: FakaN4Kavera folded before Flop
Seat 5: kalopara folded before Flop (didn't bet)
Seat 6: egoor199 collected ($0.31)



PokerStars Zoom Hand #257879913791:  Hold'em No Limit ($0.02/$0.05) - 2025/09/25 19:20:05 JST [2025/09/25 6:20:05 ET]
Table 'Donati' 6-max Seat #1 is the button
Seat 1: goaßmaß-fips ($9.71 in chips) 
Seat 2: zodapoker ($5.41 in chips) 
Seat 3: FakaN4Kavera ($7.59 in chips) 
Seat 4: KRSofM ($4.57 in chips) 
Seat 5: faithfulness ($5.37 in chips) 
Seat 6: hatater ($5.24 in chips) 
zodapoker: posts small blind $0.02
FakaN4Kavera: posts big blind $0.05
*** HOLE CARDS ***
Dealt to FakaN4Kavera [Th 4h]
KRSofM: raises $0.05 to $0.10
faithfulness: folds 
hatater: folds 
goaßmaß-fips: folds 
zodapoker: folds 
FakaN4Kavera: folds 
Uncalled bet ($0.05) returned to KRSofM
KRSofM collected $0.12 from pot
KRSofM: doesn't show hand 
*** SUMMARY ***
Total pot $0.12 | Rake $0 
Seat 1: goaßmaß-fips (button) folded before Flop (didn't bet)
Seat 2: zodapoker (small blind) folded before Flop
Seat 3: FakaN4Kavera (big blind) folded before Flop
Seat 4: KRSofM collected ($0.12)
Seat 5: faithfulness folded before Flop (didn't bet)
Seat 6: hatater folded before Flop (didn't bet)



PokerStars Zoom Hand #257879914541:  Hold'em No Limit ($0.02/$0.05) - 2025/09/25 19:20:13 JST [2025/09/25 6:20:13 ET]
Table 'Donati' 6-max Seat #1 is the button
Seat 1: kmc4444 ($6.17 in chips) 
Seat 2: _jay_44_jas ($5.57 in chips) 
Seat 3: faithfulness ($5 in chips) 
Seat 4: FakaN4Kavera ($7.54 in chips) 
Seat 5: 1Kronos ($15.89 in chips) 
Seat 6: goaßmaß-fips ($9.71 in chips) 
_jay_44_jas: posts small blind $0.02
faithfulness: posts big blind $0.05
*** HOLE CARDS ***
Dealt to FakaN4Kavera [9s Kc]
FakaN4Kavera: folds 
1Kronos: folds 
goaßmaß-fips: raises $0.10 to $0.15
kmc4444: folds 
_jay_44_jas: folds 
faithfulness: folds 
Uncalled bet ($0.10) returned to goaßmaß-fips
goaßmaß-fips collected $0.12 from pot
goaßmaß-fips: doesn't show hand 
*** SUMMARY ***
Total pot $0.12 | Rake $0 
Seat 1: kmc4444 (button) folded before Flop (didn't bet)
Seat 2: _jay_44_jas (small blind) folded before Flop
Seat 3: faithfulness (big blind) folded before Flop
Seat 4: FakaN4Kavera folded before Flop (didn't bet)
Seat 5: 1Kronos folded before Flop (didn't bet)
Seat 6: goaßmaß-fips collected ($0.12)



PokerStars Zoom Hand #257879914941:  Hold'em No Limit ($0.02/$0.05) - 2025/09/25 19:20:17 JST [2025/09/25 6:20:17 ET]
Table 'Donati' 6-max Seat #1 is the button
Seat 1: FakaN4Kavera ($7.54 in chips) 
Seat 2: YAG5292 ($9.61 in chips) 
Seat 3: KRSofM ($4.64 in chips) 
Seat 4: gio119 ($5.39 in chips) 
Seat 5: huyjokezy ($5.08 in chips) 
Seat 6: Vasco4430 ($6.13 in chips) 
YAG5292: posts small blind $0.02
KRSofM: posts big blind $0.05
*** HOLE CARDS ***
Dealt to FakaN4Kavera [6d Qh]
gio119: folds 
huyjokezy: folds 
Vasco4430: folds 
FakaN4Kavera: raises $0.07 to $0.12
YAG5292: folds 
KRSofM: folds 
Uncalled bet ($0.07) returned to FakaN4Kavera
FakaN4Kavera collected $0.12 from pot
FakaN4Kavera: doesn't show hand 
*** SUMMARY ***
Total pot $0.12 | Rake $0 
Seat 1: FakaN4Kavera (button) collected ($0.12)
Seat 2: YAG5292 (small blind) folded before Flop
Seat 3: KRSofM (big blind) folded before Flop
Seat 4: gio119 folded before Flop (didn't bet)
Seat 5: huyjokezy folded before Flop (didn't bet)
Seat 6: Vasco4430 folded before Flop (didn't bet)



PokerStars Zoom Hand #257879916311:  Hold'em No Limit ($0.02/$0.05) - 2025/09/25 19:20:32 JST [2025/09/25 6:20:32 ET]
Table 'Donati' 6-max Seat #1 is the button
Seat 1: faithfulness ($5.17 in chips) 
Seat 2: intentii ($5 in chips) 
Seat 3: gena60 ($9.33 in chips) 
Seat 4: _jay_44_jas ($5.55 in chips) 
Seat 5: kmc4444 ($5 in chips) 
Seat 6: FakaN4Kavera ($7.61 in chips) 
intentii: posts small blind $0.02
gena60: posts big blind $0.05
*** HOLE CARDS ***
Dealt to FakaN4Kavera [Kc Jh]
_jay_44_jas: folds 
kmc4444: folds 
FakaN4Kavera: raises $0.07 to $0.12
faithfulness: folds 
intentii: folds 
gena60: raises $0.26 to $0.38
FakaN4Kavera: folds 
Uncalled bet ($0.26) returned to gena60
gena60 collected $0.26 from pot
gena60: doesn't show hand 
*** SUMMARY ***
Total pot $0.26 | Rake $0 
Seat 1: faithfulness (button) folded before Flop (didn't bet)
Seat 2: intentii (small blind) folded before Flop
Seat 3: gena60 (big blind) collected ($0.26)
Seat 4: _jay_44_jas folded before Flop (didn't bet)
Seat 5: kmc4444 folded before Flop (didn't bet)
Seat 6: FakaN4Kavera folded before Flop



PokerStars Zoom Hand #257879919751:  Hold'em No Limit ($0.02/$0.05) - 2025/09/25 19:21:09 JST [2025/09/25 6:21:09 ET]
Table 'Donati' 6-max Seat #1 is the button
Seat 1: goaßmaß-fips ($9.71 in chips) 
Seat 2: bigdaveys ($10.59 in chips) 
Seat 3: gio119 ($5 in chips) 
Seat 4: faithfulness ($5.07 in chips) 
Seat 5: FakaN4Kavera ($7.49 in chips) 
Seat 6: Baikasas ($5 in chips) 
bigdaveys: posts small blind $0.02
gio119: posts big blind $0.05
*** HOLE CARDS ***
Dealt to FakaN4Kavera [3c 7s]
faithfulness: folds 
FakaN4Kavera: folds 
Baikasas: raises $0.06 to $0.11
goaßmaß-fips: calls $0.11
bigdaveys: raises $0.46 to $0.57
gio119: folds 
Baikasas: folds 
goaßmaß-fips: folds 
Uncalled bet ($0.46) returned to bigdaveys
bigdaveys collected $0.38 from pot
bigdaveys: doesn't show hand 
*** SUMMARY ***
Total pot $0.38 | Rake $0 
Seat 1: goaßmaß-fips (button) folded before Flop
Seat 2: bigdaveys (small blind) collected ($0.38)
Seat 3: gio119 (big blind) folded before Flop
Seat 4: faithfulness folded before Flop (didn't bet)
Seat 5: FakaN4Kavera folded before Flop (didn't bet)
Seat 6: Baikasas folded before Flop



PokerStars Zoom Hand #257879920491:  Hold'em No Limit ($0.02/$0.05) - 2025/09/25 19:21:17 JST [2025/09/25 6:21:17 ET]
Table 'Donati' 6-max Seat #1 is the button
Seat 1: faithfulness ($5 in chips) 
Seat 2: FakaN4Kavera ($7.49 in chips) 
Seat 3: elmex886 ($5.05 in chips) 
Seat 4: Woidprophet ($6.33 in chips) 
Seat 5: Ingyeoking ($5.52 in chips) 
Seat 6: snake oil 12 ($5.45 in chips) 
FakaN4Kavera: posts small blind $0.02
elmex886: posts big blind $0.05
*** HOLE CARDS ***
Dealt to FakaN4Kavera [Js As]
Woidprophet: raises $0.10 to $0.15
Ingyeoking: raises $0.30 to $0.45
snake oil 12: folds 
faithfulness: folds 
FakaN4Kavera: folds 
elmex886: folds 
Woidprophet: folds 
Uncalled bet ($0.30) returned to Ingyeoking
Ingyeoking collected $0.37 from pot
Ingyeoking: doesn't show hand 
*** SUMMARY ***
Total pot $0.37 | Rake $0 
Seat 1: faithfulness (button) folded before Flop (didn't bet)
Seat 2: FakaN4Kavera (small blind) folded before Flop
Seat 3: elmex886 (big blind) folded before Flop
Seat 4: Woidprophet folded before Flop
Seat 5: Ingyeoking collected ($0.37)
Seat 6: snake oil 12 folded before Flop (didn't bet)



PokerStars Zoom Hand #257879922823:  Hold'em No Limit ($0.02/$0.05) - 2025/09/25 19:21:42 JST [2025/09/25 6:21:42 ET]
Table 'Donati' 6-max Seat #1 is the button
Seat 1: KRSofM ($4.99 in chips) 
Seat 2: Ingyeoking ($5.74 in chips) 
Seat 3: gio119 ($5.44 in chips) 
Seat 4: VXNX$157 ($4.13 in chips) 
Seat 5: Woidprophet ($6 in chips) 
Seat 6: FakaN4Kavera ($7.47 in chips) 
Ingyeoking: posts small blind $0.02
gio119: posts big blind $0.05
*** HOLE CARDS ***
Dealt to FakaN4Kavera [7c 4d]
VXNX$157: folds 
Woidprophet: folds 
FakaN4Kavera: folds 
KRSofM: folds 
Ingyeoking: folds 
Uncalled bet ($0.03) returned to gio119
gio119 collected $0.04 from pot
gio119: doesn't show hand 
*** SUMMARY ***
Total pot $0.04 | Rake $0 
Seat 1: KRSofM (button) folded before Flop (didn't bet)
Seat 2: Ingyeoking (small blind) folded before Flop
Seat 3: gio119 (big blind) collected ($0.04)
Seat 4: VXNX$157 folded before Flop (didn't bet)
Seat 5: Woidprophet folded before Flop (didn't bet)
Seat 6: FakaN4Kavera folded before Flop (didn't bet)



PokerStars Zoom Hand #257879923179:  Hold'em No Limit ($0.02/$0.05) - 2025/09/25 19:21:46 JST [2025/09/25 6:21:46 ET]
Table 'Donati' 6-max Seat #1 is the button
Seat 1: Woidprophet ($6 in chips) 
Seat 2: gm__701 ($5.36 in chips) 
Seat 3: FakaN4Kavera ($7.47 in chips) 
Seat 4: intentii ($5.46 in chips) 
Seat 5: huyjokezy ($5.15 in chips) 
Seat 6: serg430606 ($4.65 in chips) 
gm__701: posts small blind $0.02
FakaN4Kavera: posts big blind $0.05
*** HOLE CARDS ***
Dealt to FakaN4Kavera [Kc Qd]
intentii: raises $0.08 to $0.13
huyjokezy: folds 
serg430606: folds 
Woidprophet: calls $0.13
gm__701: folds 
FakaN4Kavera: calls $0.08
*** FLOP *** [Ac Qh 8c]
FakaN4Kavera: checks 
intentii: bets $0.20
Woidprophet: folds 
FakaN4Kavera: folds 
Uncalled bet ($0.20) returned to intentii
intentii collected $0.39 from pot
intentii: doesn't show hand 
*** SUMMARY ***
Total pot $0.41 | Rake $0.02 
Board [Ac Qh 8c]
Seat 1: Woidprophet (button) folded on the Flop
Seat 2: gm__701 (small blind) folded before Flop
Seat 3: FakaN4Kavera (big blind) folded on the Flop
Seat 4: intentii collected ($0.39)
Seat 5: huyjokezy folded before Flop (didn't bet)
Seat 6: serg430606 folded before Flop (didn't bet)



PokerStars Zoom Hand #257879925937:  Hold'em No Limit ($0.02/$0.05) - 2025/09/25 19:22:16 JST [2025/09/25 6:22:16 ET]
Table 'Donati' 6-max Seat #1 is the button
Seat 1: BretticusX ($6.30 in chips) 
Seat 2: FakaN4Kavera ($7.34 in chips) 
Seat 3: gm__701 ($5.05 in chips) 
Seat 4: KRSofM ($5 in chips) 
Seat 5: egoor199 ($6.18 in chips) 
Seat 6: Woidprophet ($5.18 in chips) 
FakaN4Kavera: posts small blind $0.02
gm__701: posts big blind $0.05
*** HOLE CARDS ***
Dealt to FakaN4Kavera [Qc Td]
KRSofM: folds 
egoor199: folds 
Woidprophet: folds 
BretticusX: raises $0.07 to $0.12
FakaN4Kavera: folds 
gm__701: folds 
Uncalled bet ($0.07) returned to BretticusX
BretticusX collected $0.12 from pot
BretticusX: doesn't show hand 
*** SUMMARY ***
Total pot $0.12 | Rake $0 
Seat 1: BretticusX (button) collected ($0.12)
Seat 2: FakaN4Kavera (small blind) folded before Flop
Seat 3: gm__701 (big blind) folded before Flop
Seat 4: KRSofM folded before Flop (didn't bet)
Seat 5: egoor199 folded before Flop (didn't bet)
Seat 6: Woidprophet folded before Flop (didn't bet)



PokerStars Zoom Hand #257879928274:  Hold'em No Limit ($0.02/$0.05) - 2025/09/25 19:22:41 JST [2025/09/25 6:22:41 ET]
Table 'Donati' 6-max Seat #1 is the button
Seat 1: VXNX$157 ($4.19 in chips) 
Seat 2: sk1bbz ($5.15 in chips) 
Seat 3: faithfulness ($5.07 in chips) 
Seat 4: gio119 ($5.39 in chips) 
Seat 5: FakaN4Kavera ($7.32 in chips) 
Seat 6: gm__701 ($5 in chips) 
sk1bbz: posts small blind $0.02
faithfulness: posts big blind $0.05
*** HOLE CARDS ***
Dealt to FakaN4Kavera [4h As]
gio119: folds 
FakaN4Kavera: folds 
gm__701: folds 
VXNX$157: folds 
sk1bbz: calls $0.03
faithfulness: raises $0.15 to $0.20
sk1bbz: folds 
Uncalled bet ($0.15) returned to faithfulness
faithfulness collected $0.10 from pot
faithfulness: doesn't show hand 
*** SUMMARY ***
Total pot $0.10 | Rake $0 
Seat 1: VXNX$157 (button) folded before Flop (didn't bet)
Seat 2: sk1bbz (small blind) folded before Flop
Seat 3: faithfulness (big blind) collected ($0.10)
Seat 4: gio119 folded before Flop (didn't bet)
Seat 5: FakaN4Kavera folded before Flop (didn't bet)
Seat 6: gm__701 folded before Flop (didn't bet)



PokerStars Zoom Hand #257879929045:  Hold'em No Limit ($0.02/$0.05) - 2025/09/25 19:22:49 JST [2025/09/25 6:22:49 ET]
Table 'Donati' 6-max Seat #1 is the button
Seat 1: FakaN4Kavera ($7.32 in chips) 
Seat 2: Schafkopfaa ($4.95 in chips) 
Seat 3: kmc4444 ($5.40 in chips) 
Seat 4: Woidprophet ($5.25 in chips) 
Seat 5: gio119 ($5 in chips) 
Seat 6: VXNX$157 ($4.19 in chips) 
Schafkopfaa: posts small blind $0.02
kmc4444: posts big blind $0.05
*** HOLE CARDS ***
Dealt to FakaN4Kavera [Js 2c]
Woidprophet: folds 
gio119: folds 
VXNX$157: folds 
FakaN4Kavera: raises $0.07 to $0.12
Schafkopfaa: folds 
kmc4444: folds 
Uncalled bet ($0.07) returned to FakaN4Kavera
FakaN4Kavera collected $0.12 from pot
FakaN4Kavera: doesn't show hand 
*** SUMMARY ***
Total pot $0.12 | Rake $0 
Seat 1: FakaN4Kavera (button) collected ($0.12)
Seat 2: Schafkopfaa (small blind) folded before Flop
Seat 3: kmc4444 (big blind) folded before Flop
Seat 4: Woidprophet folded before Flop (didn't bet)
Seat 5: gio119 folded before Flop (didn't bet)
Seat 6: VXNX$157 folded before Flop (didn't bet)



PokerStars Zoom Hand #257879931112:  Hold'em No Limit ($0.02/$0.05) - 2025/09/25 19:23:12 JST [2025/09/25 6:23:12 ET]
Table 'Donati' 6-max Seat #1 is the button
Seat 1: kalopara ($10.41 in chips) 
Seat 2: BrickByBrick68 ($18.61 in chips) 
Seat 3: VXNX$157 ($4.17 in chips) 
Seat 4: FakaN4Kavera ($7.39 in chips) 
Seat 5: pink bull 78 ($2.86 in chips) 
Seat 6: faithfulness ($5 in chips) 
BrickByBrick68: posts small blind $0.02
VXNX$157: posts big blind $0.05
*** HOLE CARDS ***
Dealt to FakaN4Kavera [9h 6c]
FakaN4Kavera: folds 
pink bull 78: folds 
faithfulness: raises $0.07 to $0.12
kalopara: folds 
BrickByBrick68: folds 
VXNX$157: calls $0.07
*** FLOP *** [As 7c 4h]
VXNX$157: checks 
faithfulness: bets $0.07
VXNX$157: raises $0.26 to $0.33
faithfulness: folds 
Uncalled bet ($0.26) returned to VXNX$157
VXNX$157 collected $0.38 from pot
VXNX$157: doesn't show hand 
*** SUMMARY ***
Total pot $0.40 | Rake $0.02 
Board [As 7c 4h]
Seat 1: kalopara (button) folded before Flop (didn't bet)
Seat 2: BrickByBrick68 (small blind) folded before Flop
Seat 3: VXNX$157 (big blind) collected ($0.38)
Seat 4: FakaN4Kavera folded before Flop (didn't bet)
Seat 5: pink bull 78 folded before Flop (didn't bet)
Seat 6: faithfulness folded on the Flop



PokerStars Zoom Hand #257879931450:  Hold'em No Limit ($0.02/$0.05) - 2025/09/25 19:23:16 JST [2025/09/25 6:23:16 ET]
Table 'Donati' 6-max Seat #1 is the button
Seat 1: Baikasas ($5.02 in chips) 
Seat 2: zodapoker ($4.66 in chips) 
Seat 3: huyjokezy ($5.48 in chips) 
Seat 4: Irrubikajs ($2.50 in chips) 
Seat 5: FakaN4Kavera ($7.39 in chips) 
Seat 6: gio119 ($5.32 in chips) 
zodapoker: posts small blind $0.02
huyjokezy: posts big blind $0.05
*** HOLE CARDS ***
Dealt to FakaN4Kavera [Kh Qd]
Irrubikajs: raises $0.05 to $0.10
FakaN4Kavera: calls $0.10
gio119: folds 
Baikasas: folds 
zodapoker: folds 
huyjokezy: calls $0.05
*** FLOP *** [Jc 9c Ts]
huyjokezy: checks 
Irrubikajs: checks 
FakaN4Kavera: bets $0.10
huyjokezy: calls $0.10
Irrubikajs: folds 
*** TURN *** [Jc 9c Ts] [2d]
huyjokezy: checks 
FakaN4Kavera: bets $0.25
huyjokezy: calls $0.25
*** RIVER *** [Jc 9c Ts 2d] [As]
huyjokezy: checks 
FakaN4Kavera: bets $1.28
huyjokezy: folds 
Uncalled bet ($1.28) returned to FakaN4Kavera
FakaN4Kavera collected $0.98 from pot
FakaN4Kavera: doesn't show hand 
*** SUMMARY ***
Total pot $1.02 | Rake $0.04 
Board [Jc 9c Ts 2d As]
Seat 1: Baikasas (button) folded before Flop (didn't bet)
Seat 2: zodapoker (small blind) folded before Flop
Seat 3: huyjokezy (big blind) folded on the River
Seat 4: Irrubikajs folded on the Flop
Seat 5: FakaN4Kavera collected ($0.98)
Seat 6: gio119 folded before Flop (didn't bet)



PokerStars Zoom Hand #257879936090:  Hold'em No Limit ($0.02/$0.05) - 2025/09/25 19:24:05 JST [2025/09/25 6:24:05 ET]
Table 'Donati' 6-max Seat #1 is the button
Seat 1: zodapoker ($5.62 in chips) 
Seat 2: huyjokezy ($5.03 in chips) 
Seat 3: FakaN4Kavera ($7.92 in chips) 
Seat 4: YAG5292 ($4.87 in chips) 
Seat 5: Epist461 ($5.27 in chips) 
Seat 6: Woidprophet ($6.28 in chips) 
huyjokezy: posts small blind $0.02
FakaN4Kavera: posts big blind $0.05
*** HOLE CARDS ***
Dealt to FakaN4Kavera [6c 3c]
YAG5292: folds 
Epist461: raises $0.05 to $0.10
Woidprophet: folds 
zodapoker: folds 
huyjokezy: folds 
FakaN4Kavera: folds 
Uncalled bet ($0.05) returned to Epist461
Epist461 collected $0.12 from pot
Epist461: doesn't show hand 
*** SUMMARY ***
Total pot $0.12 | Rake $0 
Seat 1: zodapoker (button) folded before Flop (didn't bet)
Seat 2: huyjokezy (small blind) folded before Flop
Seat 3: FakaN4Kavera (big blind) folded before Flop
Seat 4: YAG5292 folded before Flop (didn't bet)
Seat 5: Epist461 collected ($0.12)
Seat 6: Woidprophet folded before Flop (didn't bet)



PokerStars Zoom Hand #257879936883:  Hold'em No Limit ($0.02/$0.05) - 2025/09/25 19:24:13 JST [2025/09/25 6:24:13 ET]
Table 'Donati' 6-max Seat #1 is the button
Seat 1: faithfulness ($5.12 in chips) 
Seat 2: FakaN4Kavera ($7.87 in chips) 
Seat 3: elmex886 ($5.10 in chips) 
Seat 4: gio119 ($5.02 in chips) 
Seat 5: huyjokezy ($5.01 in chips) 
Seat 6: VXNX$157 ($4.36 in chips) 
FakaN4Kavera: posts small blind $0.02
elmex886: posts big blind $0.05
*** HOLE CARDS ***
Dealt to FakaN4Kavera [As Ts]
gio119: folds 
huyjokezy: folds 
VXNX$157: folds 
faithfulness: raises $0.07 to $0.12
FakaN4Kavera: calls $0.10
elmex886: folds 
*** FLOP *** [5d 2h Jc]
FakaN4Kavera: checks 
faithfulness: checks 
*** TURN *** [5d 2h Jc] [Ad]
FakaN4Kavera: bets $0.09
faithfulness: folds 
Uncalled bet ($0.09) returned to FakaN4Kavera
FakaN4Kavera collected $0.28 from pot
FakaN4Kavera: doesn't show hand 
*** SUMMARY ***
Total pot $0.29 | Rake $0.01 
Board [5d 2h Jc Ad]
Seat 1: faithfulness (button) folded on the Turn
Seat 2: FakaN4Kavera (small blind) collected ($0.28)
Seat 3: elmex886 (big blind) folded before Flop
Seat 4: gio119 folded before Flop (didn't bet)
Seat 5: huyjokezy folded before Flop (didn't bet)
Seat 6: VXNX$157 folded before Flop (didn't bet)



PokerStars Zoom Hand #257879940607:  Hold'em No Limit ($0.02/$0.05) - 2025/09/25 19:24:53 JST [2025/09/25 6:24:53 ET]
Table 'Donati' 6-max Seat #1 is the button
Seat 1: FakaN4Kavera ($8.03 in chips) 
Seat 2: kmc4444 ($5.02 in chips) 
Seat 3: lebifflemaster ($8.95 in chips) 
Seat 4: Kenzo2211 ($8.39 in chips) 
Seat 5: Ingyeoking ($9.62 in chips) 
Seat 6: Epist461 ($5.22 in chips) 
kmc4444: posts small blind $0.02
lebifflemaster: posts big blind $0.05
*** HOLE CARDS ***
Dealt to FakaN4Kavera [Jc 9d]
Kenzo2211: raises $0.05 to $0.10
Ingyeoking: folds 
Epist461: folds 
FakaN4Kavera: folds 
kmc4444: folds 
lebifflemaster: calls $0.05
*** FLOP *** [8c Kc Jd]
lebifflemaster: checks 
Kenzo2211: bets $0.07
lebifflemaster: folds 
Uncalled bet ($0.07) returned to Kenzo2211
Kenzo2211 collected $0.21 from pot
Kenzo2211: doesn't show hand 
*** SUMMARY ***
Total pot $0.22 | Rake $0.01 
Board [8c Kc Jd]
Seat 1: FakaN4Kavera (button) folded before Flop (didn't bet)
Seat 2: kmc4444 (small blind) folded before Flop
Seat 3: lebifflemaster (big blind) folded on the Flop
Seat 4: Kenzo2211 collected ($0.21)
Seat 5: Ingyeoking folded before Flop (didn't bet)
Seat 6: Epist461 folded before Flop (didn't bet)



PokerStars Zoom Hand #257879941035:  Hold'em No Limit ($0.02/$0.05) - 2025/09/25 19:24:58 JST [2025/09/25 6:24:58 ET]
Table 'Donati' 6-max Seat #1 is the button
Seat 1: delfinato200 ($14.10 in chips) 
Seat 2: elmex886 ($5.12 in chips) 
Seat 3: sepik200 ($5.36 in chips) 
Seat 4: BretticusX ($5.99 in chips) 
Seat 5: Woidprophet ($6.08 in chips) 
Seat 6: FakaN4Kavera ($8.03 in chips) 
elmex886: posts small blind $0.02
sepik200: posts big blind $0.05
*** HOLE CARDS ***
Dealt to FakaN4Kavera [6c 6d]
BretticusX: folds 
Woidprophet: folds 
FakaN4Kavera: raises $0.07 to $0.12
delfinato200: calls $0.12
elmex886: folds 
sepik200: calls $0.07
*** FLOP *** [Td Jd 7h]
sepik200: bets $0.05
FakaN4Kavera: calls $0.05
delfinato200: folds 
*** TURN *** [Td Jd 7h] [7c]
sepik200: bets $0.05
FakaN4Kavera: calls $0.05
*** RIVER *** [Td Jd 7h 7c] [7s]
sepik200: checks 
FakaN4Kavera: checks 
*** SHOW DOWN ***
sepik200: shows [Kh Qs] (three of a kind, Sevens)
FakaN4Kavera: shows [6c 6d] (a full house, Sevens full of Sixes)
FakaN4Kavera collected $0.56 from pot
*** SUMMARY ***
Total pot $0.58 | Rake $0.02 
Board [Td Jd 7h 7c 7s]
Seat 1: delfinato200 (button) folded on the Flop
Seat 2: elmex886 (small blind) folded before Flop
Seat 3: sepik200 (big blind) showed [Kh Qs] and lost with three of a kind, Sevens
Seat 4: BretticusX folded before Flop (didn't bet)
Seat 5: Woidprophet folded before Flop (didn't bet)
Seat 6: FakaN4Kavera showed [6c 6d] and won ($0.56) with a full house, Sevens full of Sixes



PokerStars Zoom Hand #257879945546:  Hold'em No Limit ($0.02/$0.05) - 2025/09/25 19:25:46 JST [2025/09/25 6:25:46 ET]
Table 'Donati' 6-max Seat #1 is the button
Seat 1: gio119 ($5 in chips) 
Seat 2: Gogart87 ($6.83 in chips) 
Seat 3: FakaN4Kavera ($8.37 in chips) 
Seat 4: intentii ($5 in chips) 
Seat 5: huyjokezy ($5.07 in chips) 
Seat 6: koshchey_a ($6.95 in chips) 
Gogart87: posts small blind $0.02
FakaN4Kavera: posts big blind $0.05
*** HOLE CARDS ***
Dealt to FakaN4Kavera [7h Jh]
intentii: folds 
huyjokezy: folds 
koshchey_a: folds 
gio119: folds 
Gogart87: folds 
Uncalled bet ($0.03) returned to FakaN4Kavera
FakaN4Kavera collected $0.04 from pot
FakaN4Kavera: doesn't show hand 
*** SUMMARY ***
Total pot $0.04 | Rake $0 
Seat 1: gio119 (button) folded before Flop (didn't bet)
Seat 2: Gogart87 (small blind) folded before Flop
Seat 3: FakaN4Kavera (big blind) collected ($0.04)
Seat 4: intentii folded before Flop (didn't bet)
Seat 5: huyjokezy folded before Flop (didn't bet)
Seat 6: koshchey_a folded before Flop (didn't bet)



PokerStars Zoom Hand #257879945086:  Hold'em No Limit ($0.02/$0.05) - 2025/09/25 19:25:41 JST [2025/09/25 6:25:41 ET]
Table 'Donati' 6-max Seat #1 is the button
Seat 1: Schafkopfaa ($9.03 in chips) 
Seat 2: huyjokezy ($5 in chips) 
Seat 3: delfinato200 ($13.98 in chips) 
Seat 4: elmex886 ($5.03 in chips) 
Seat 5: FakaN4Kavera ($8.37 in chips) 
Seat 6: Ingyeoking ($3.70 in chips) 
huyjokezy: posts small blind $0.02
delfinato200: posts big blind $0.05
*** HOLE CARDS ***
Dealt to FakaN4Kavera [7s Qs]
elmex886: folds 
FakaN4Kavera: folds 
Ingyeoking: folds 
Schafkopfaa: calls $0.05
huyjokezy: raises $0.20 to $0.25
delfinato200: raises $13.73 to $13.98 and is all-in
Schafkopfaa: folds 
huyjokezy: folds 
Uncalled bet ($13.73) returned to delfinato200
delfinato200 collected $0.55 from pot
delfinato200: doesn't show hand 
*** SUMMARY ***
Total pot $0.55 | Rake $0 
Seat 1: Schafkopfaa (button) folded before Flop
Seat 2: huyjokezy (small blind) folded before Flop
Seat 3: delfinato200 (big blind) collected ($0.55)
Seat 4: elmex886 folded before Flop (didn't bet)
Seat 5: FakaN4Kavera folded before Flop (didn't bet)
Seat 6: Ingyeoking folded before Flop (didn't bet)



PokerStars Zoom Hand #257879947639:  Hold'em No Limit ($0.02/$0.05) - 2025/09/25 19:26:09 JST [2025/09/25 6:26:09 ET]
Table 'Donati' 6-max Seat #1 is the button
Seat 1: Epist461 ($5.34 in chips) 
Seat 2: alpaz01 ($4.78 in chips) 
Seat 3: YAG5292 ($5.16 in chips) 
Seat 4: gio119 ($5 in chips) 
Seat 5: 1Kronos ($10.19 in chips) 
Seat 6: FakaN4Kavera ($8.39 in chips) 
alpaz01: posts small blind $0.02
YAG5292: posts big blind $0.05
*** HOLE CARDS ***
Dealt to FakaN4Kavera [Kc 4s]
gio119: folds 
1Kronos: folds 
FakaN4Kavera: folds 
Epist461: folds 
alpaz01: raises $0.10 to $0.15
YAG5292: folds 
Uncalled bet ($0.10) returned to alpaz01
alpaz01 collected $0.10 from pot
alpaz01: doesn't show hand 
*** SUMMARY ***
Total pot $0.10 | Rake $0 
Seat 1: Epist461 (button) folded before Flop (didn't bet)
Seat 2: alpaz01 (small blind) collected ($0.10)
Seat 3: YAG5292 (big blind) folded before Flop
Seat 4: gio119 folded before Flop (didn't bet)
Seat 5: 1Kronos folded before Flop (didn't bet)
Seat 6: FakaN4Kavera folded before Flop (didn't bet)



PokerStars Zoom Hand #257879948642:  Hold'em No Limit ($0.02/$0.05) - 2025/09/25 19:26:20 JST [2025/09/25 6:26:20 ET]
Table 'Donati' 6-max Seat #1 is the button
Seat 1: gm__701 ($5.40 in chips) 
Seat 2: YAG5292 ($5.11 in chips) 
Seat 3: Gogart87 ($6.81 in chips) 
Seat 4: gio119 ($5.29 in chips) 
Seat 5: FakaN4Kavera ($8.37 in chips) 
Seat 6: Irrubikajs ($2.58 in chips) 
YAG5292: posts small blind $0.02
Gogart87: posts big blind $0.05
*** HOLE CARDS ***
Dealt to FakaN4Kavera [Jd 5s]
gio119: folds 
FakaN4Kavera: folds 
Irrubikajs: folds 
gm__701: folds 
YAG5292: folds 
Uncalled bet ($0.03) returned to Gogart87
Gogart87 collected $0.04 from pot
Gogart87: doesn't show hand 
*** SUMMARY ***
Total pot $0.04 | Rake $0 
Seat 1: gm__701 (button) folded before Flop (didn't bet)
Seat 2: YAG5292 (small blind) folded before Flop
Seat 3: Gogart87 (big blind) collected ($0.04)
Seat 4: gio119 folded before Flop (didn't bet)
Seat 5: FakaN4Kavera folded before Flop (didn't bet)
Seat 6: Irrubikajs folded before Flop (didn't bet)



PokerStars Zoom Hand #257879949011:  Hold'em No Limit ($0.02/$0.05) - 2025/09/25 19:26:24 JST [2025/09/25 6:26:24 ET]
Table 'Donati' 6-max Seat #1 is the button
Seat 1: FakaN4Kavera ($8.37 in chips) 
Seat 2: 1Kronos ($10.14 in chips) 
Seat 3: gm__701 ($5.40 in chips) 
Seat 4: Woidprophet ($5.13 in chips) 
Seat 5: alpaz01 ($4.83 in chips) 
Seat 6: gio119 ($5.29 in chips) 
1Kronos: posts small blind $0.02
gm__701: posts big blind $0.05
*** HOLE CARDS ***
Dealt to FakaN4Kavera [4s Jh]
Woidprophet: folds 
alpaz01: folds 
gio119: folds 
FakaN4Kavera: raises $0.07 to $0.12
1Kronos: raises $0.43 to $0.55
gm__701: folds 
FakaN4Kavera: folds 
Uncalled bet ($0.43) returned to 1Kronos
1Kronos collected $0.29 from pot
1Kronos: doesn't show hand 
*** SUMMARY ***
Total pot $0.29 | Rake $0 
Seat 1: FakaN4Kavera (button) folded before Flop
Seat 2: 1Kronos (small blind) collected ($0.29)
Seat 3: gm__701 (big blind) folded before Flop
Seat 4: Woidprophet folded before Flop (didn't bet)
Seat 5: alpaz01 folded before Flop (didn't bet)
Seat 6: gio119 folded before Flop (didn't bet)



PokerStars Zoom Hand #257879948300:  Hold'em No Limit ($0.02/$0.05) - 2025/09/25 19:26:16 JST [2025/09/25 6:26:16 ET]
Table 'Donati' 6-max Seat #1 is the button
Seat 1: zodapoker ($6.80 in chips) 
Seat 2: FakaN4Kavera ($8.39 in chips) 
Seat 3: serg430606 ($5.21 in chips) 
Seat 4: Ingyeoking ($3.68 in chips) 
Seat 5: intentii ($6.74 in chips) 
Seat 6: huyjokezy ($5.87 in chips) 
FakaN4Kavera: posts small blind $0.02
serg430606: posts big blind $0.05
*** HOLE CARDS ***
Dealt to FakaN4Kavera [8d 6d]
Ingyeoking: folds 
intentii: folds 
huyjokezy: folds 
zodapoker: raises $0.07 to $0.12
FakaN4Kavera: folds 
serg430606: calls $0.07
*** FLOP *** [2s Jd Kd]
serg430606: checks 
zodapoker: bets $0.13
serg430606: folds 
Uncalled bet ($0.13) returned to zodapoker
zodapoker collected $0.25 from pot
zodapoker: doesn't show hand 
*** SUMMARY ***
Total pot $0.26 | Rake $0.01 
Board [2s Jd Kd]
Seat 1: zodapoker (button) collected ($0.25)
Seat 2: FakaN4Kavera (small blind) folded before Flop
Seat 3: serg430606 (big blind) folded on the Flop
Seat 4: Ingyeoking folded before Flop (didn't bet)
Seat 5: intentii folded before Flop (didn't bet)
Seat 6: huyjokezy folded before Flop (didn't bet)



PokerStars Zoom Hand #257879950664:  Hold'em No Limit ($0.02/$0.05) - 2025/09/25 19:26:42 JST [2025/09/25 6:26:42 ET]
Table 'Donati' 6-max Seat #1 is the button
Seat 1: 1Kronos ($8.01 in chips) 
Seat 2: snake oil 12 ($5.38 in chips) 
Seat 3: gio119 ($5 in chips) 
Seat 4: FakaN4Kavera ($8.25 in chips) 
Seat 5: faithfulness ($5 in chips) 
Seat 6: zodapoker ($4.40 in chips) 
snake oil 12: posts small blind $0.02
gio119: posts big blind $0.05
*** HOLE CARDS ***
Dealt to FakaN4Kavera [3h 5s]
FakaN4Kavera: folds 
faithfulness: folds 
zodapoker: folds 
1Kronos: folds 
snake oil 12: folds 
Uncalled bet ($0.03) returned to gio119
gio119 collected $0.04 from pot
gio119: doesn't show hand 
*** SUMMARY ***
Total pot $0.04 | Rake $0 
Seat 1: 1Kronos (button) folded before Flop (didn't bet)
Seat 2: snake oil 12 (small blind) folded before Flop
Seat 3: gio119 (big blind) collected ($0.04)
Seat 4: FakaN4Kavera folded before Flop (didn't bet)
Seat 5: faithfulness folded before Flop (didn't bet)
Seat 6: zodapoker folded before Flop (didn't bet)



PokerStars Zoom Hand #257879950964:  Hold'em No Limit ($0.02/$0.05) - 2025/09/25 19:26:45 JST [2025/09/25 6:26:45 ET]
Table 'Donati' 6-max Seat #1 is the button
Seat 1: lebifflemaster ($5 in chips) 
Seat 2: Irrubikajs ($2.53 in chips) 
Seat 3: FakaN4Kavera ($8.25 in chips) 
Seat 4: YAG5292 ($9.44 in chips) 
Seat 5: Choi Moneky ($5.31 in chips) 
Seat 6: faithfulness ($5 in chips) 
Irrubikajs: posts small blind $0.02
FakaN4Kavera: posts big blind $0.05
*** HOLE CARDS ***
Dealt to FakaN4Kavera [4d Tc]
YAG5292: folds 
Choi Moneky: folds 
faithfulness: raises $0.07 to $0.12
lebifflemaster: raises $0.25 to $0.37
Irrubikajs: folds 
FakaN4Kavera: folds 
faithfulness: folds 
Uncalled bet ($0.25) returned to lebifflemaster
lebifflemaster collected $0.31 from pot
lebifflemaster: doesn't show hand 
*** SUMMARY ***
Total pot $0.31 | Rake $0 
Seat 1: lebifflemaster (button) collected ($0.31)
Seat 2: Irrubikajs (small blind) folded before Flop
Seat 3: FakaN4Kavera (big blind) folded before Flop
Seat 4: YAG5292 folded before Flop (didn't bet)
Seat 5: Choi Moneky folded before Flop (didn't bet)
Seat 6: faithfulness folded before Flop



PokerStars Zoom Hand #257879952895:  Hold'em No Limit ($0.02/$0.05) - 2025/09/25 19:27:06 JST [2025/09/25 6:27:06 ET]
Table 'Donati' 6-max Seat #1 is the button
Seat 1: semmely ($5.23 in chips) 
Seat 2: YAG5292 ($9.46 in chips) 
Seat 3: alpaz01 ($4.94 in chips) 
Seat 4: FakaN4Kavera ($8.20 in chips) 
Seat 5: 1Kronos ($10.39 in chips) 
Seat 6: goaßmaß-fips ($7.65 in chips) 
YAG5292: posts small blind $0.02
alpaz01: posts big blind $0.05
*** HOLE CARDS ***
Dealt to FakaN4Kavera [4c Ad]
FakaN4Kavera: folds 
1Kronos: folds 
goaßmaß-fips: folds 
semmely: folds 
YAG5292: folds 
Uncalled bet ($0.03) returned to alpaz01
alpaz01 collected $0.04 from pot
alpaz01: doesn't show hand 
*** SUMMARY ***
Total pot $0.04 | Rake $0 
Seat 1: semmely (button) folded before Flop (didn't bet)
Seat 2: YAG5292 (small blind) folded before Flop
Seat 3: alpaz01 (big blind) collected ($0.04)
Seat 4: FakaN4Kavera folded before Flop (didn't bet)
Seat 5: 1Kronos folded before Flop (didn't bet)
Seat 6: goaßmaß-fips folded before Flop (didn't bet)



PokerStars Zoom Hand #257879951967:  Hold'em No Limit ($0.02/$0.05) - 2025/09/25 19:26:56 JST [2025/09/25 6:26:56 ET]
Table 'Donati' 6-max Seat #1 is the button
Seat 1: TTPP92 ($4.35 in chips) 
Seat 2: gio119 ($5.17 in chips) 
Seat 3: leakleakA ($8.62 in chips) 
Seat 4: bigdaveys ($11.82 in chips) 
Seat 5: huyjokezy ($5 in chips) 
Seat 6: FakaN4Kavera ($8.20 in chips) 
gio119: posts small blind $0.02
leakleakA: posts big blind $0.05
*** HOLE CARDS ***
Dealt to FakaN4Kavera [As Jh]
bigdaveys: raises $0.07 to $0.12
huyjokezy: folds 
FakaN4Kavera: folds 
TTPP92: folds 
gio119: folds 
leakleakA: calls $0.07
*** FLOP *** [Ac 2c 5c]
leakleakA: checks 
bigdaveys: bets $0.08
leakleakA: folds 
Uncalled bet ($0.08) returned to bigdaveys
bigdaveys collected $0.25 from pot
bigdaveys: doesn't show hand 
*** SUMMARY ***
Total pot $0.26 | Rake $0.01 
Board [Ac 2c 5c]
Seat 1: TTPP92 (button) folded before Flop (didn't bet)
Seat 2: gio119 (small blind) folded before Flop
Seat 3: leakleakA (big blind) folded on the Flop
Seat 4: bigdaveys collected ($0.25)
Seat 5: huyjokezy folded before Flop (didn't bet)
Seat 6: FakaN4Kavera folded before Flop (didn't bet)



PokerStars Zoom Hand #257879954694:  Hold'em No Limit ($0.02/$0.05) - 2025/09/25 19:27:27 JST [2025/09/25 6:27:27 ET]
Table 'Donati' 6-max Seat #1 is the button
Seat 1: tomis1312 ($5 in chips) 
Seat 2: FakaN4Kavera ($8.20 in chips) 
Seat 3: BrickByBrick68 ($18.76 in chips) 
Seat 4: Schöngeist71 ($7.75 in chips) 
Seat 5: leakleakA ($8.50 in chips) 
Seat 6: YAG5292 ($9.30 in chips) 
FakaN4Kavera: posts small blind $0.02
BrickByBrick68: posts big blind $0.05
*** HOLE CARDS ***
Dealt to FakaN4Kavera [Tc 7s]
Schöngeist71: folds 
leakleakA: folds 
YAG5292: folds 
tomis1312: folds 
FakaN4Kavera: folds 
Uncalled bet ($0.03) returned to BrickByBrick68
BrickByBrick68 collected $0.04 from pot
BrickByBrick68: doesn't show hand 
*** SUMMARY ***
Total pot $0.04 | Rake $0 
Seat 1: tomis1312 (button) folded before Flop (didn't bet)
Seat 2: FakaN4Kavera (small blind) folded before Flop
Seat 3: BrickByBrick68 (big blind) collected ($0.04)
Seat 4: Schöngeist71 folded before Flop (didn't bet)
Seat 5: leakleakA folded before Flop (didn't bet)
Seat 6: YAG5292 folded before Flop (didn't bet)



PokerStars Zoom Hand #257879953611:  Hold'em No Limit ($0.02/$0.05) - 2025/09/25 19:27:15 JST [2025/09/25 6:27:15 ET]
Table 'Donati' 6-max Seat #1 is the button
Seat 1: kmc4444 ($5.02 in chips) 
Seat 2: huyjokezy ($5 in chips) 
Seat 3: 1Kronos ($10.39 in chips) 
Seat 4: kalopara ($4.93 in chips) 
Seat 5: FakaN4Kavera ($8.20 in chips) 
Seat 6: zodapoker ($5.73 in chips) 
huyjokezy: posts small blind $0.02
1Kronos: posts big blind $0.05
*** HOLE CARDS ***
Dealt to FakaN4Kavera [9c Jc]
kalopara: folds 
FakaN4Kavera: folds 
zodapoker: raises $0.07 to $0.12
kmc4444: folds 
huyjokezy: folds 
1Kronos: calls $0.07
*** FLOP *** [5h 3s Ac]
1Kronos: checks 
zodapoker: bets $0.08
1Kronos: calls $0.08
*** TURN *** [5h 3s Ac] [Kd]
1Kronos: checks 
zodapoker: bets $0.30
1Kronos: folds 
Uncalled bet ($0.30) returned to zodapoker
zodapoker collected $0.40 from pot
zodapoker: doesn't show hand 
*** SUMMARY ***
Total pot $0.42 | Rake $0.02 
Board [5h 3s Ac Kd]
Seat 1: kmc4444 (button) folded before Flop (didn't bet)
Seat 2: huyjokezy (small blind) folded before Flop
Seat 3: 1Kronos (big blind) folded on the Turn
Seat 4: kalopara folded before Flop (didn't bet)
Seat 5: FakaN4Kavera folded before Flop (didn't bet)
Seat 6: zodapoker collected ($0.40)



PokerStars Zoom Hand #257879956269:  Hold'em No Limit ($0.02/$0.05) - 2025/09/25 19:27:44 JST [2025/09/25 6:27:44 ET]
Table 'Donati' 6-max Seat #1 is the button
Seat 1: delfinato200 ($14.25 in chips) 
Seat 2: egoor199 ($6.05 in chips) 
Seat 3: tomis1312 ($5 in chips) 
Seat 4: FakaN4Kavera ($8.18 in chips) 
Seat 5: Ingyeoking ($3.74 in chips) 
Seat 6: huyjokezy ($5 in chips) 
egoor199: posts small blind $0.02
tomis1312: posts big blind $0.05
*** HOLE CARDS ***
Dealt to FakaN4Kavera [8c 7d]
FakaN4Kavera: folds 
Ingyeoking: folds 
huyjokezy: raises $0.10 to $0.15
delfinato200: folds 
egoor199: folds 
tomis1312: folds 
Uncalled bet ($0.10) returned to huyjokezy
huyjokezy collected $0.12 from pot
huyjokezy: doesn't show hand 
*** SUMMARY ***
Total pot $0.12 | Rake $0 
Seat 1: delfinato200 (button) folded before Flop (didn't bet)
Seat 2: egoor199 (small blind) folded before Flop
Seat 3: tomis1312 (big blind) folded before Flop
Seat 4: FakaN4Kavera folded before Flop (didn't bet)
Seat 5: Ingyeoking folded before Flop (didn't bet)
Seat 6: huyjokezy collected ($0.12)



PokerStars Zoom Hand #257879956999:  Hold'em No Limit ($0.02/$0.05) - 2025/09/25 19:27:52 JST [2025/09/25 6:27:52 ET]
Table 'Donati' 6-max Seat #1 is the button
Seat 1: Baikasas ($5.75 in chips) 
Seat 2: gm__701 ($5.71 in chips) 
Seat 3: FakaN4Kavera ($8.18 in chips) 
Seat 4: leakleakA ($8.43 in chips) 
Seat 5: gena60 ($12 in chips) 
Seat 6: huyjokezy ($5.98 in chips) 
gm__701: posts small blind $0.02
FakaN4Kavera: posts big blind $0.05
*** HOLE CARDS ***
Dealt to FakaN4Kavera [Ac 8d]
leakleakA: folds 
gena60: folds 
huyjokezy: folds 
Baikasas: folds 
gm__701: folds 
Uncalled bet ($0.03) returned to FakaN4Kavera
FakaN4Kavera collected $0.04 from pot
FakaN4Kavera: doesn't show hand 
*** SUMMARY ***
Total pot $0.04 | Rake $0 
Seat 1: Baikasas (button) folded before Flop (didn't bet)
Seat 2: gm__701 (small blind) folded before Flop
Seat 3: FakaN4Kavera (big blind) collected ($0.04)
Seat 4: leakleakA folded before Flop (didn't bet)
Seat 5: gena60 folded before Flop (didn't bet)
Seat 6: huyjokezy folded before Flop (didn't bet)



PokerStars Zoom Hand #257879956528:  Hold'em No Limit ($0.02/$0.05) - 2025/09/25 19:27:47 JST [2025/09/25 6:27:47 ET]
Table 'Donati' 6-max Seat #1 is the button
Seat 1: kmc4444 ($5.45 in chips) 
Seat 2: semmely ($5.18 in chips) 
Seat 3: 1Kronos ($10.45 in chips) 
Seat 4: TTPP92 ($4.28 in chips) 
Seat 5: YAG5292 ($9.30 in chips) 
Seat 6: FakaN4Kavera ($8.18 in chips) 
semmely: posts small blind $0.02
1Kronos: posts big blind $0.05
*** HOLE CARDS ***
Dealt to FakaN4Kavera [Kh 9d]
TTPP92: folds 
YAG5292: folds 
FakaN4Kavera: folds 
kmc4444: folds 
semmely: calls $0.03
1Kronos: raises $0.20 to $0.25
semmely: folds 
Uncalled bet ($0.20) returned to 1Kronos
1Kronos collected $0.10 from pot
1Kronos: doesn't show hand 
*** SUMMARY ***
Total pot $0.10 | Rake $0 
Seat 1: kmc4444 (button) folded before Flop (didn't bet)
Seat 2: semmely (small blind) folded before Flop
Seat 3: 1Kronos (big blind) collected ($0.10)
Seat 4: TTPP92 folded before Flop (didn't bet)
Seat 5: YAG5292 folded before Flop (didn't bet)
Seat 6: FakaN4Kavera folded before Flop (didn't bet)



PokerStars Zoom Hand #257879954967:  Hold'em No Limit ($0.02/$0.05) - 2025/09/25 19:27:30 JST [2025/09/25 6:27:30 ET]
Table 'Donati' 6-max Seat #1 is the button
Seat 1: FakaN4Kavera ($8.18 in chips) 
Seat 2: egoor199 ($3.68 in chips) 
Seat 3: Schöngeist71 ($7.75 in chips) 
Seat 4: serg430606 ($4.63 in chips) 
Seat 5: BretticusX ($6.14 in chips) 
Seat 6: TTPP92 ($4.28 in chips) 
egoor199: posts small blind $0.02
Schöngeist71: posts big blind $0.05
*** HOLE CARDS ***
Dealt to FakaN4Kavera [Kh 6h]
serg430606: raises $0.10 to $0.15
BretticusX: folds 
TTPP92: folds 
FakaN4Kavera: folds 
egoor199: folds 
Schöngeist71: calls $0.10
*** FLOP *** [Th Kd 7c]
Schöngeist71: checks 
serg430606: bets $0.15
Schöngeist71: calls $0.15
*** TURN *** [Th Kd 7c] [As]
Schöngeist71: checks 
serg430606: bets $0.25
Schöngeist71: calls $0.25
*** RIVER *** [Th Kd 7c As] [Ac]
Schöngeist71: checks 
serg430606: bets $0.54
Schöngeist71: calls $0.54
*** SHOW DOWN ***
serg430606: shows [7d 7s] (a full house, Sevens full of Aces)
Schöngeist71: mucks hand 
serg430606 collected $2.11 from pot
*** SUMMARY ***
Total pot $2.20 | Rake $0.09 
Board [Th Kd 7c As Ac]
Seat 1: FakaN4Kavera (button) folded before Flop (didn't bet)
Seat 2: egoor199 (small blind) folded before Flop
Seat 3: Schöngeist71 (big blind) mucked [Ks 2s]
Seat 4: serg430606 showed [7d 7s] and won ($2.11) with a full house, Sevens full of Aces
Seat 5: BretticusX folded before Flop (didn't bet)
Seat 6: TTPP92 folded before Flop (didn't bet)



PokerStars Zoom Hand #257879958778:  Hold'em No Limit ($0.02/$0.05) - 2025/09/25 19:28:11 JST [2025/09/25 6:28:11 ET]
Table 'Donati' 6-max Seat #1 is the button
Seat 1: FakaN4Kavera ($8.20 in chips) 
Seat 2: kmc4444 ($6.39 in chips) 
Seat 3: delfinato200 ($14.23 in chips) 
Seat 4: Epist461 ($5 in chips) 
Seat 5: emmachan415 ($5 in chips) 
Seat 6: gena60 ($12 in chips) 
kmc4444: posts small blind $0.02
delfinato200: posts big blind $0.05
*** HOLE CARDS ***
Dealt to FakaN4Kavera [7h 8c]
Epist461: folds 
emmachan415: folds 
gena60: folds 
FakaN4Kavera: folds 
kmc4444: folds 
Uncalled bet ($0.03) returned to delfinato200
delfinato200 collected $0.04 from pot
delfinato200: doesn't show hand 
*** SUMMARY ***
Total pot $0.04 | Rake $0 
Seat 1: FakaN4Kavera (button) folded before Flop (didn't bet)
Seat 2: kmc4444 (small blind) folded before Flop
Seat 3: delfinato200 (big blind) collected ($0.04)
Seat 4: Epist461 folded before Flop (didn't bet)
Seat 5: emmachan415 folded before Flop (didn't bet)
Seat 6: gena60 folded before Flop (didn't bet)



PokerStars Zoom Hand #257879959888:  Hold'em No Limit ($0.02/$0.05) - 2025/09/25 19:28:23 JST [2025/09/25 6:28:23 ET]
Table 'Donati' 6-max Seat #1 is the button
Seat 1: Baikasas ($5 in chips) 
Seat 2: gm__701 ($5.40 in chips) 
Seat 3: gena60 ($12 in chips) 
Seat 4: FakaN4Kavera ($8.20 in chips) 
Seat 5: zodapoker ($4.42 in chips) 
Seat 6: Ingyeoking ($5.48 in chips) 
gm__701: posts small blind $0.02
gena60: posts big blind $0.05
*** HOLE CARDS ***
Dealt to FakaN4Kavera [8d Jc]
FakaN4Kavera: folds 
zodapoker: folds 
Ingyeoking: raises $0.07 to $0.12
Baikasas: folds 
gm__701: folds 
gena60: folds 
Uncalled bet ($0.07) returned to Ingyeoking
Ingyeoking collected $0.12 from pot
Ingyeoking: doesn't show hand 
*** SUMMARY ***
Total pot $0.12 | Rake $0 
Seat 1: Baikasas (button) folded before Flop (didn't bet)
Seat 2: gm__701 (small blind) folded before Flop
Seat 3: gena60 (big blind) folded before Flop
Seat 4: FakaN4Kavera folded before Flop (didn't bet)
Seat 5: zodapoker folded before Flop (didn't bet)
Seat 6: Ingyeoking collected ($0.12)



PokerStars Zoom Hand #257879960161:  Hold'em No Limit ($0.02/$0.05) - 2025/09/25 19:28:26 JST [2025/09/25 6:28:26 ET]
Table 'Donati' 6-max Seat #1 is the button
Seat 1: Junney Jade ($2.95 in chips) 
Seat 2: FakaN4Kavera ($8.20 in chips) 
Seat 3: intentii ($5.40 in chips) 
Seat 4: elmex886 ($5 in chips) 
Seat 5: zodapoker ($5.95 in chips) 
Seat 6: egoor199 ($3.59 in chips) 
FakaN4Kavera: posts small blind $0.02
intentii: posts big blind $0.05
*** HOLE CARDS ***
Dealt to FakaN4Kavera [Kh 4s]
elmex886: folds 
zodapoker: folds 
egoor199: raises $0.05 to $0.10
Junney Jade: folds 
FakaN4Kavera: folds 
intentii: folds 
Uncalled bet ($0.05) returned to egoor199
egoor199 collected $0.12 from pot
egoor199: doesn't show hand 
*** SUMMARY ***
Total pot $0.12 | Rake $0 
Seat 1: Junney Jade (button) folded before Flop (didn't bet)
Seat 2: FakaN4Kavera (small blind) folded before Flop
Seat 3: intentii (big blind) folded before Flop
Seat 4: elmex886 folded before Flop (didn't bet)
Seat 5: zodapoker folded before Flop (didn't bet)
Seat 6: egoor199 collected ($0.12)



PokerStars Zoom Hand #257879961077:  Hold'em No Limit ($0.02/$0.05) - 2025/09/25 19:28:36 JST [2025/09/25 6:28:36 ET]
Table 'Donati' 6-max Seat #1 is the button
Seat 1: gio119 ($9.95 in chips) 
Seat 2: alexnffc1 ($1.59 in chips) 
Seat 3: FakaN4Kavera ($8.18 in chips) 
Seat 4: delfinato200 ($14.25 in chips) 
Seat 5: Vasco4430 ($8.61 in chips) 
Seat 6: Kenzo2211 ($8.30 in chips) 
alexnffc1: posts small blind $0.02
FakaN4Kavera: posts big blind $0.05
*** HOLE CARDS ***
Dealt to FakaN4Kavera [Td Ts]
delfinato200: folds 
Vasco4430: raises $0.10 to $0.15
Kenzo2211: folds 
gio119: folds 
alexnffc1: folds 
FakaN4Kavera: raises $0.32 to $0.47
Vasco4430: calls $0.32
*** FLOP *** [9c 5s Qc]
FakaN4Kavera: checks 
Vasco4430: bets $0.46
FakaN4Kavera: calls $0.46
*** TURN *** [9c 5s Qc] [Qh]
FakaN4Kavera: checks 
Vasco4430: bets $0.90
FakaN4Kavera: folds 
Uncalled bet ($0.90) returned to Vasco4430
Vasco4430 collected $1.80 from pot
Vasco4430: doesn't show hand 
*** SUMMARY ***
Total pot $1.88 | Rake $0.08 
Board [9c 5s Qc Qh]
Seat 1: gio119 (button) folded before Flop (didn't bet)
Seat 2: alexnffc1 (small blind) folded before Flop
Seat 3: FakaN4Kavera (big blind) folded on the Turn
Seat 4: delfinato200 folded before Flop (didn't bet)
Seat 5: Vasco4430 collected ($1.80)
Seat 6: Kenzo2211 folded before Flop (didn't bet)



PokerStars Zoom Hand #257879959522:  Hold'em No Limit ($0.02/$0.05) - 2025/09/25 19:28:19 JST [2025/09/25 6:28:19 ET]
Table 'Donati' 6-max Seat #1 is the button
Seat 1: lebifflemaster ($5.33 in chips) 
Seat 2: gio119 ($9.97 in chips) 
Seat 3: Irrubikajs ($3.31 in chips) 
Seat 4: emmachan415 ($5 in chips) 
Seat 5: FakaN4Kavera ($8.20 in chips) 
Seat 6: VXNX$157 ($4.35 in chips) 
gio119: posts small blind $0.02
Irrubikajs: posts big blind $0.05
*** HOLE CARDS ***
Dealt to FakaN4Kavera [4c 8c]
emmachan415: raises $0.07 to $0.12
FakaN4Kavera: folds 
VXNX$157: folds 
lebifflemaster: folds 
gio119: folds 
Irrubikajs: raises $0.48 to $0.60
emmachan415: calls $0.48
*** FLOP *** [7d 5c 7h]
Irrubikajs: bets $0.88
emmachan415: calls $0.88
*** TURN *** [7d 5c 7h] [6c]
Irrubikajs: bets $1.83 and is all-in
emmachan415: calls $1.83
*** RIVER *** [7d 5c 7h 6c] [Ah]
*** SHOW DOWN ***
Irrubikajs: shows [Ad Kh] (two pair, Aces and Sevens)
emmachan415: shows [Kc Ks] (two pair, Kings and Sevens)
Irrubikajs collected $6.36 from pot
*** SUMMARY ***
Total pot $6.64 | Rake $0.28 
Board [7d 5c 7h 6c Ah]
Seat 1: lebifflemaster (button) folded before Flop (didn't bet)
Seat 2: gio119 (small blind) folded before Flop
Seat 3: Irrubikajs (big blind) showed [Ad Kh] and won ($6.36) with two pair, Aces and Sevens
Seat 4: emmachan415 showed [Kc Ks] and lost with two pair, Kings and Sevens
Seat 5: FakaN4Kavera folded before Flop (didn't bet)
Seat 6: VXNX$157 folded before Flop (didn't bet)



PokerStars Zoom Hand #257879965242:  Hold'em No Limit ($0.02/$0.05) - 2025/09/25 19:29:20 JST [2025/09/25 6:29:20 ET]
Table 'Donati' 6-max Seat #1 is the button
Seat 1: lebifflemaster ($9.29 in chips) 
Seat 2: VXNX$157 ($4.28 in chips) 
Seat 3: koshchey_a ($6.88 in chips) 
Seat 4: FakaN4Kavera ($7.25 in chips) 
Seat 5: Ingyeoking ($2.99 in chips) 
Seat 6: YAG5292 ($9.03 in chips) 
VXNX$157: posts small blind $0.02
koshchey_a: posts big blind $0.05
*** HOLE CARDS ***
Dealt to FakaN4Kavera [4h 5c]
FakaN4Kavera: folds 
Ingyeoking: raises $0.05 to $0.10
YAG5292: raises $0.21 to $0.31
lebifflemaster: folds 
VXNX$157: folds 
koshchey_a: folds 
Ingyeoking: calls $0.21
*** FLOP *** [Qc 9h Jd]
Ingyeoking: checks 
YAG5292: bets $0.33
Ingyeoking: folds 
Uncalled bet ($0.33) returned to YAG5292
YAG5292 collected $0.66 from pot
YAG5292: doesn't show hand 
*** SUMMARY ***
Total pot $0.69 | Rake $0.03 
Board [Qc 9h Jd]
Seat 1: lebifflemaster (button) folded before Flop (didn't bet)
Seat 2: VXNX$157 (small blind) folded before Flop
Seat 3: koshchey_a (big blind) folded before Flop
Seat 4: FakaN4Kavera folded before Flop (didn't bet)
Seat 5: Ingyeoking folded on the Flop
Seat 6: YAG5292 collected ($0.66)



PokerStars Zoom Hand #257879967903:  Hold'em No Limit ($0.02/$0.05) - 2025/09/25 19:29:48 JST [2025/09/25 6:29:48 ET]
Table 'Donati' 6-max Seat #1 is the button
Seat 1: 1Kronos ($10.12 in chips) 
Seat 2: Ingyeoking ($9.59 in chips) 
Seat 3: FakaN4Kavera ($7.23 in chips) 
Seat 4: YAG5292 ($5.97 in chips) 
Seat 5: kmc4444 ($5.12 in chips) 
Seat 6: Baikasas ($5 in chips) 
Ingyeoking: posts small blind $0.02
FakaN4Kavera: posts big blind $0.05
*** HOLE CARDS ***
Dealt to FakaN4Kavera [Tc Qh]
YAG5292: raises $0.09 to $0.14
kmc4444: folds 
Baikasas: folds 
1Kronos: folds 
Ingyeoking: folds 
FakaN4Kavera: folds 
Uncalled bet ($0.09) returned to YAG5292
YAG5292 collected $0.12 from pot
YAG5292: doesn't show hand 
*** SUMMARY ***
Total pot $0.12 | Rake $0 
Seat 1: 1Kronos (button) folded before Flop (didn't bet)
Seat 2: Ingyeoking (small blind) folded before Flop
Seat 3: FakaN4Kavera (big blind) folded before Flop
Seat 4: YAG5292 collected ($0.12)
Seat 5: kmc4444 folded before Flop (didn't bet)
Seat 6: Baikasas folded before Flop (didn't bet)



PokerStars Zoom Hand #257879965503:  Hold'em No Limit ($0.02/$0.05) - 2025/09/25 19:29:23 JST [2025/09/25 6:29:23 ET]
Table 'Donati' 6-max Seat #1 is the button
Seat 1: FakaN4Kavera ($7.25 in chips) 
Seat 2: Ingyeoking ($3.98 in chips) 
Seat 3: Vasco4430 ($9.48 in chips) 
Seat 4: bigdaveys ($12.02 in chips) 
Seat 5: gio119 ($5.25 in chips) 
Seat 6: gm__701 ($5.30 in chips) 
Ingyeoking: posts small blind $0.02
Vasco4430: posts big blind $0.05
*** HOLE CARDS ***
Dealt to FakaN4Kavera [6s 4s]
bigdaveys: folds 
gio119: calls $0.05
gm__701: folds 
FakaN4Kavera: folds 
Ingyeoking: calls $0.03
Vasco4430: checks 
*** FLOP *** [Ts 8d 8h]
Ingyeoking: checks 
Vasco4430: checks 
gio119: bets $0.14
Ingyeoking: folds 
Vasco4430: calls $0.14
*** TURN *** [Ts 8d 8h] [9s]
Vasco4430: checks 
gio119: checks 
*** RIVER *** [Ts 8d 8h 9s] [7d]
Vasco4430: checks 
gio119: checks 
*** SHOW DOWN ***
Vasco4430: shows [9c 7h] (two pair, Nines and Eights)
gio119: shows [Qd Qh] (two pair, Queens and Eights)
gio119 collected $0.41 from pot
*** SUMMARY ***
Total pot $0.43 | Rake $0.02 
Board [Ts 8d 8h 9s 7d]
Seat 1: FakaN4Kavera (button) folded before Flop (didn't bet)
Seat 2: Ingyeoking (small blind) folded on the Flop
Seat 3: Vasco4430 (big blind) showed [9c 7h] and lost with two pair, Nines and Eights
Seat 4: bigdaveys folded before Flop (didn't bet)
Seat 5: gio119 showed [Qd Qh] and won ($0.41) with two pair, Queens and Eights
Seat 6: gm__701 folded before Flop (didn't bet)



PokerStars Zoom Hand #257879969275:  Hold'em No Limit ($0.02/$0.05) - 2025/09/25 19:30:02 JST [2025/09/25 6:30:02 ET]
Table 'Donati' 6-max Seat #1 is the button
Seat 1: zodapoker ($5.83 in chips) 
Seat 2: Geeuzpeace;) ($5.28 in chips) 
Seat 3: kmc4444 ($5.12 in chips) 
Seat 4: Ingyeoking ($9.57 in chips) 
Seat 5: _jay_44_jas ($7.23 in chips) 
Seat 6: FakaN4Kavera ($7.18 in chips) 
Geeuzpeace;): posts small blind $0.02
kmc4444: posts big blind $0.05
*** HOLE CARDS ***
Dealt to FakaN4Kavera [Ks Qh]
Ingyeoking: folds 
_jay_44_jas: folds 
FakaN4Kavera: raises $0.07 to $0.12
zodapoker: folds 
Geeuzpeace;): folds 
kmc4444: folds 
Uncalled bet ($0.07) returned to FakaN4Kavera
FakaN4Kavera collected $0.12 from pot
FakaN4Kavera: doesn't show hand 
*** SUMMARY ***
Total pot $0.12 | Rake $0 
Seat 1: zodapoker (button) folded before Flop (didn't bet)
Seat 2: Geeuzpeace;) (small blind) folded before Flop
Seat 3: kmc4444 (big blind) folded before Flop
Seat 4: Ingyeoking folded before Flop (didn't bet)
Seat 5: _jay_44_jas folded before Flop (didn't bet)
Seat 6: FakaN4Kavera collected ($0.12)



PokerStars Zoom Hand #257879964768:  Hold'em No Limit ($0.02/$0.05) - 2025/09/25 19:29:15 JST [2025/09/25 6:29:15 ET]
Table 'Donati' 6-max Seat #1 is the button
Seat 1: elmex886 ($5.44 in chips) 
Seat 2: kmc4444 ($6.25 in chips) 
Seat 3: franks270 ($8.07 in chips) 
Seat 4: Gogart87 ($5.07 in chips) 
Seat 5: sepik200 ($5.50 in chips) 
Seat 6: FakaN4Kavera ($7.25 in chips) 
kmc4444: posts small blind $0.02
franks270: posts big blind $0.05
*** HOLE CARDS ***
Dealt to FakaN4Kavera [Ks 6d]
Gogart87: folds 
sepik200: calls $0.05
FakaN4Kavera: folds 
elmex886: folds 
kmc4444: calls $0.03
franks270: checks 
*** FLOP *** [7s 3h 3c]
kmc4444: checks 
franks270: checks 
sepik200: checks 
*** TURN *** [7s 3h 3c] [9d]
kmc4444: checks 
franks270: checks 
sepik200: checks 
*** RIVER *** [7s 3h 3c 9d] [4c]
kmc4444: bets $0.18
franks270: folds 
sepik200: folds 
Uncalled bet ($0.18) returned to kmc4444
kmc4444 collected $0.14 from pot
kmc4444: doesn't show hand 
*** SUMMARY ***
Total pot $0.15 | Rake $0.01 
Board [7s 3h 3c 9d 4c]
Seat 1: elmex886 (button) folded before Flop (didn't bet)
Seat 2: kmc4444 (small blind) collected ($0.14)
Seat 3: franks270 (big blind) folded on the River
Seat 4: Gogart87 folded before Flop (didn't bet)
Seat 5: sepik200 folded on the River
Seat 6: FakaN4Kavera folded before Flop (didn't bet)



PokerStars Zoom Hand #257879971704:  Hold'em No Limit ($0.02/$0.05) - 2025/09/25 19:30:28 JST [2025/09/25 6:30:28 ET]
Table 'Donati' 6-max Seat #1 is the button
Seat 1: tomis1312 ($5 in chips) 
Seat 2: elmex886 ($5.19 in chips) 
Seat 3: koshchey_a ($7.05 in chips) 
Seat 4: FakaN4Kavera ($7.25 in chips) 
Seat 5: intentii ($9.14 in chips) 
Seat 6: egoor199 ($3.59 in chips) 
elmex886: posts small blind $0.02
koshchey_a: posts big blind $0.05
*** HOLE CARDS ***
Dealt to FakaN4Kavera [6c Ts]
FakaN4Kavera: folds 
intentii: folds 
egoor199: raises $0.05 to $0.10
tomis1312: folds 
elmex886: folds 
koshchey_a: folds 
Uncalled bet ($0.05) returned to egoor199
egoor199 collected $0.12 from pot
egoor199: doesn't show hand 
*** SUMMARY ***
Total pot $0.12 | Rake $0 
Seat 1: tomis1312 (button) folded before Flop (didn't bet)
Seat 2: elmex886 (small blind) folded before Flop
Seat 3: koshchey_a (big blind) folded before Flop
Seat 4: FakaN4Kavera folded before Flop (didn't bet)
Seat 5: intentii folded before Flop (didn't bet)
Seat 6: egoor199 collected ($0.12)



PokerStars Zoom Hand #257879972085:  Hold'em No Limit ($0.02/$0.05) - 2025/09/25 19:30:32 JST [2025/09/25 6:30:32 ET]
Table 'Donati' 6-max Seat #1 is the button
Seat 1: Ingyeoking ($4.02 in chips) 
Seat 2: dervoigt ($4.95 in chips) 
Seat 3: TTPP92 ($5.08 in chips) 
Seat 4: FakaN4Kavera ($7.25 in chips) 
Seat 5: emmachan415 ($5.07 in chips) 
Seat 6: Irrubikajs ($2.81 in chips) 
dervoigt: posts small blind $0.02
TTPP92: posts big blind $0.05
*** HOLE CARDS ***
Dealt to FakaN4Kavera [6c 5s]
FakaN4Kavera: folds 
emmachan415: raises $0.07 to $0.12
Irrubikajs: folds 
Ingyeoking: folds 
dervoigt: folds 
TTPP92: folds 
Uncalled bet ($0.07) returned to emmachan415
emmachan415 collected $0.12 from pot
emmachan415: doesn't show hand 
*** SUMMARY ***
Total pot $0.12 | Rake $0 
Seat 1: Ingyeoking (button) folded before Flop (didn't bet)
Seat 2: dervoigt (small blind) folded before Flop
Seat 3: TTPP92 (big blind) folded before Flop
Seat 4: FakaN4Kavera folded before Flop (didn't bet)
Seat 5: emmachan415 collected ($0.12)
Seat 6: Irrubikajs folded before Flop (didn't bet)



PokerStars Zoom Hand #257879967322:  Hold'em No Limit ($0.02/$0.05) - 2025/09/25 19:29:42 JST [2025/09/25 6:29:42 ET]
Table 'Donati' 6-max Seat #1 is the button
Seat 1: Gogart87 ($5 in chips) 
Seat 2: 1Kronos ($10.14 in chips) 
Seat 3: koshchey_a ($5.94 in chips) 
Seat 4: delfinato200 ($14.48 in chips) 
Seat 5: FakaN4Kavera ($7.23 in chips) 
Seat 6: _jay_44_jas ($7.25 in chips) 
1Kronos: posts small blind $0.02
koshchey_a: posts big blind $0.05
*** HOLE CARDS ***
Dealt to FakaN4Kavera [6c 2d]
delfinato200: calls $0.05
FakaN4Kavera: folds 
_jay_44_jas: folds 
Gogart87: raises $0.15 to $0.20
1Kronos: folds 
koshchey_a: folds 
delfinato200: calls $0.15
*** FLOP *** [4h As Ad]
delfinato200: checks 
Gogart87: checks 
*** TURN *** [4h As Ad] [Qc]
delfinato200: checks 
Gogart87: checks 
*** RIVER *** [4h As Ad Qc] [7c]
delfinato200: checks 
Gogart87: checks 
*** SHOW DOWN ***
delfinato200: shows [Ts Th] (two pair, Aces and Tens)
Gogart87: mucks hand 
delfinato200 collected $0.45 from pot
*** SUMMARY ***
Total pot $0.47 | Rake $0.02 
Board [4h As Ad Qc 7c]
Seat 1: Gogart87 (button) mucked [5d 5c]
Seat 2: 1Kronos (small blind) folded before Flop
Seat 3: koshchey_a (big blind) folded before Flop
Seat 4: delfinato200 showed [Ts Th] and won ($0.45) with two pair, Aces and Tens
Seat 5: FakaN4Kavera folded before Flop (didn't bet)
Seat 6: _jay_44_jas folded before Flop (didn't bet)



PokerStars Zoom Hand #257879971048:  Hold'em No Limit ($0.02/$0.05) - 2025/09/25 19:30:21 JST [2025/09/25 6:30:21 ET]
Table 'Donati' 6-max Seat #1 is the button
Seat 1: FakaN4Kavera ($7.25 in chips) 
Seat 2: sepik200 ($5.45 in chips) 
Seat 3: DurandalMIA ($5.47 in chips) 
Seat 4: kmc4444 ($5 in chips) 
Seat 5: semmely ($5.51 in chips) 
Seat 6: Geeuzpeace;) ($5.26 in chips) 
sepik200: posts small blind $0.02
DurandalMIA: posts big blind $0.05
*** HOLE CARDS ***
Dealt to FakaN4Kavera [2s Kc]
kmc4444: folds 
semmely: folds 
Geeuzpeace;): calls $0.05
FakaN4Kavera: folds 
sepik200: calls $0.03
DurandalMIA: checks 
*** FLOP *** [8h Th Kh]
sepik200: checks 
DurandalMIA: bets $0.14
Geeuzpeace;): calls $0.14
sepik200: folds 
*** TURN *** [8h Th Kh] [9s]
DurandalMIA: checks 
Geeuzpeace;): bets $0.10
DurandalMIA: calls $0.10
*** RIVER *** [8h Th Kh 9s] [6h]
DurandalMIA: checks 
Geeuzpeace;): checks 
*** SHOW DOWN ***
DurandalMIA: shows [3c Kd] (a pair of Kings)
Geeuzpeace;): shows [7h Jd] (a flush, King high)
Geeuzpeace;) collected $0.60 from pot
*** SUMMARY ***
Total pot $0.63 | Rake $0.03 
Board [8h Th Kh 9s 6h]
Seat 1: FakaN4Kavera (button) folded before Flop (didn't bet)
Seat 2: sepik200 (small blind) folded on the Flop
Seat 3: DurandalMIA (big blind) showed [3c Kd] and lost with a pair of Kings
Seat 4: kmc4444 folded before Flop (didn't bet)
Seat 5: semmely folded before Flop (didn't bet)
Seat 6: Geeuzpeace;) showed [7h Jd] and won ($0.60) with a flush, King high



PokerStars Zoom Hand #257879965996:  Hold'em No Limit ($0.02/$0.05) - 2025/09/25 19:29:28 JST [2025/09/25 6:29:28 ET]
Table 'Donati' 6-max Seat #1 is the button
Seat 1: Fercoronas ($2.50 in chips) 
Seat 2: FakaN4Kavera ($7.25 in chips) 
Seat 3: Gogart87 ($5.05 in chips) 
Seat 4: bigdaveys ($12.02 in chips) 
Seat 5: 1Kronos ($7.48 in chips) 
Seat 6: lebifflemaster ($9.29 in chips) 
FakaN4Kavera: posts small blind $0.02
Gogart87: posts big blind $0.05
*** HOLE CARDS ***
Dealt to FakaN4Kavera [Ac 2c]
bigdaveys: folds 
1Kronos: raises $0.07 to $0.12
lebifflemaster: raises $0.25 to $0.37
Fercoronas: folds 
FakaN4Kavera: folds 
Gogart87: folds 
1Kronos: calls $0.25
*** FLOP *** [7h 8s 7d]
1Kronos: checks 
lebifflemaster: bets $0.26
1Kronos: calls $0.26
*** TURN *** [7h 8s 7d] [Js]
1Kronos: checks 
lebifflemaster: checks 
*** RIVER *** [7h 8s 7d Js] [8c]
1Kronos: bets $1.65
lebifflemaster: folds 
Uncalled bet ($1.65) returned to 1Kronos
1Kronos collected $1.27 from pot
1Kronos: doesn't show hand 
*** SUMMARY ***
Total pot $1.33 | Rake $0.06 
Board [7h 8s 7d Js 8c]
Seat 1: Fercoronas (button) folded before Flop (didn't bet)
Seat 2: FakaN4Kavera (small blind) folded before Flop
Seat 3: Gogart87 (big blind) folded before Flop
Seat 4: bigdaveys folded before Flop (didn't bet)
Seat 5: 1Kronos collected ($1.27)
Seat 6: lebifflemaster folded on the River



PokerStars Zoom Hand #257879972678:  Hold'em No Limit ($0.02/$0.05) - 2025/09/25 19:30:39 JST [2025/09/25 6:30:39 ET]
Table 'Donati' 6-max Seat #1 is the button
Seat 1: Ingyeoking ($5.66 in chips) 
Seat 2: FakaN4Kavera ($7.25 in chips) 
Seat 3: VXNX$157 ($4.47 in chips) 
Seat 4: Kenzo2211 ($6.61 in chips) 
Seat 5: intentii ($5.29 in chips) 
Seat 6: 1Kronos ($10.24 in chips) 
FakaN4Kavera: posts small blind $0.02
VXNX$157: posts big blind $0.05
*** HOLE CARDS ***
Dealt to FakaN4Kavera [7h 3d]
Kenzo2211: folds 
intentii: raises $0.08 to $0.13
1Kronos: raises $0.25 to $0.38
Ingyeoking: folds 
FakaN4Kavera: folds 
VXNX$157: folds 
intentii: folds 
Uncalled bet ($0.25) returned to 1Kronos
1Kronos collected $0.33 from pot
1Kronos: doesn't show hand 
*** SUMMARY ***
Total pot $0.33 | Rake $0 
Seat 1: Ingyeoking (button) folded before Flop (didn't bet)
Seat 2: FakaN4Kavera (small blind) folded before Flop
Seat 3: VXNX$157 (big blind) folded before Flop
Seat 4: Kenzo2211 folded before Flop (didn't bet)
Seat 5: intentii folded before Flop
Seat 6: 1Kronos collected ($0.33)



PokerStars Zoom Hand #257879973410:  Hold'em No Limit ($0.02/$0.05) - 2025/09/25 19:30:47 JST [2025/09/25 6:30:47 ET]
Table 'Donati' 6-max Seat #1 is the button
Seat 1: TTPP92 ($5.01 in chips) 
Seat 2: emmachan415 ($5.14 in chips) 
Seat 3: 3rdguess ($5 in chips) 
Seat 4: Baikasas ($5.15 in chips) 
Seat 5: Gogart87 ($5.50 in chips) 
Seat 6: FakaN4Kavera ($7.23 in chips) 
emmachan415: posts small blind $0.02
3rdguess: posts big blind $0.05
*** HOLE CARDS ***
Dealt to FakaN4Kavera [As Kc]
Baikasas: folds 
Gogart87: folds 
FakaN4Kavera: raises $0.07 to $0.12
TTPP92: folds 
emmachan415: folds 
3rdguess: folds 
Uncalled bet ($0.07) returned to FakaN4Kavera
FakaN4Kavera collected $0.12 from pot
FakaN4Kavera: doesn't show hand 
*** SUMMARY ***
Total pot $0.12 | Rake $0 
Seat 1: TTPP92 (button) folded before Flop (didn't bet)
Seat 2: emmachan415 (small blind) folded before Flop
Seat 3: 3rdguess (big blind) folded before Flop
Seat 4: Baikasas folded before Flop (didn't bet)
Seat 5: Gogart87 folded before Flop (didn't bet)
Seat 6: FakaN4Kavera collected ($0.12)



PokerStars Zoom Hand #257879975395:  Hold'em No Limit ($0.02/$0.05) - 2025/09/25 19:31:08 JST [2025/09/25 6:31:08 ET]
Table 'Donati' 6-max Seat #1 is the button
Seat 1: sepik200 ($5.35 in chips) 
Seat 2: 1Kronos ($8.12 in chips) 
Seat 3: FakaN4Kavera ($7.30 in chips) 
Seat 4: kmc4444 ($5.26 in chips) 
Seat 5: Gogart87 ($5 in chips) 
Seat 6: goaßmaß-fips ($12.39 in chips) 
1Kronos: posts small blind $0.02
FakaN4Kavera: posts big blind $0.05
*** HOLE CARDS ***
Dealt to FakaN4Kavera [3s 8d]
kmc4444: folds 
Gogart87: folds 
goaßmaß-fips: folds 
sepik200: calls $0.05
1Kronos: folds 
FakaN4Kavera: checks 
*** FLOP *** [Th Jh Ad]
FakaN4Kavera: checks 
sepik200: bets $0.06
FakaN4Kavera: folds 
Uncalled bet ($0.06) returned to sepik200
sepik200 collected $0.12 from pot
sepik200: doesn't show hand 
*** SUMMARY ***
Total pot $0.12 | Rake $0 
Board [Th Jh Ad]
Seat 1: sepik200 (button) collected ($0.12)
Seat 2: 1Kronos (small blind) folded before Flop
Seat 3: FakaN4Kavera (big blind) folded on the Flop
Seat 4: kmc4444 folded before Flop (didn't bet)
Seat 5: Gogart87 folded before Flop (didn't bet)
Seat 6: goaßmaß-fips folded before Flop (didn't bet)



PokerStars Zoom Hand #257879978947:  Hold'em No Limit ($0.02/$0.05) - 2025/09/25 19:31:46 JST [2025/09/25 6:31:46 ET]
Table 'Donati' 6-max Seat #1 is the button
Seat 1: gio119 ($5 in chips) 
Seat 2: FakaN4Kavera ($7.25 in chips) 
Seat 3: muhaaa3000 ($4.49 in chips) 
Seat 4: Kenzo2211 ($6.01 in chips) 
Seat 5: Ingyeoking ($2.88 in chips) 
Seat 6: 1Kronos ($11.26 in chips) 
FakaN4Kavera: posts small blind $0.02
muhaaa3000: posts big blind $0.05
*** HOLE CARDS ***
Dealt to FakaN4Kavera [4s 7s]
Kenzo2211: folds 
Ingyeoking: folds 
1Kronos: folds 
gio119: folds 
FakaN4Kavera: folds 
Uncalled bet ($0.03) returned to muhaaa3000
muhaaa3000 collected $0.04 from pot
muhaaa3000: doesn't show hand 
*** SUMMARY ***
Total pot $0.04 | Rake $0 
Seat 1: gio119 (button) folded before Flop (didn't bet)
Seat 2: FakaN4Kavera (small blind) folded before Flop
Seat 3: muhaaa3000 (big blind) collected ($0.04)
Seat 4: Kenzo2211 folded before Flop (didn't bet)
Seat 5: Ingyeoking folded before Flop (didn't bet)
Seat 6: 1Kronos folded before Flop (didn't bet)



PokerStars Zoom Hand #257879979468:  Hold'em No Limit ($0.02/$0.05) - 2025/09/25 19:31:52 JST [2025/09/25 6:31:52 ET]
Table 'Donati' 6-max Seat #1 is the button
Seat 1: Kenzo2211 ($6.01 in chips) 
Seat 2: lebifflemaster ($5.09 in chips) 
Seat 3: FakaN4Kavera ($7.23 in chips) 
Seat 4: Baikasas ($5.08 in chips) 
Seat 5: leakleakA ($12.98 in chips) 
Seat 6: 1Kronos ($15.73 in chips) 
lebifflemaster: posts small blind $0.02
FakaN4Kavera: posts big blind $0.05
*** HOLE CARDS ***
Dealt to FakaN4Kavera [Th 4h]
Baikasas: folds 
leakleakA: folds 
1Kronos: folds 
Kenzo2211: raises $0.05 to $0.10
lebifflemaster: folds 
FakaN4Kavera: folds 
Uncalled bet ($0.05) returned to Kenzo2211
Kenzo2211 collected $0.12 from pot
Kenzo2211: doesn't show hand 
*** SUMMARY ***
Total pot $0.12 | Rake $0 
Seat 1: Kenzo2211 (button) collected ($0.12)
Seat 2: lebifflemaster (small blind) folded before Flop
Seat 3: FakaN4Kavera (big blind) folded before Flop
Seat 4: Baikasas folded before Flop (didn't bet)
Seat 5: leakleakA folded before Flop (didn't bet)
Seat 6: 1Kronos folded before Flop (didn't bet)



PokerStars Zoom Hand #257879980436:  Hold'em No Limit ($0.02/$0.05) - 2025/09/25 19:32:02 JST [2025/09/25 6:32:02 ET]
Table 'Donati' 6-max Seat #1 is the button
Seat 1: FakaN4Kavera ($7.18 in chips) 
Seat 2: serg430606 ($5.23 in chips) 
Seat 3: TTPP92 ($4.99 in chips) 
Seat 4: Baikasas ($5.08 in chips) 
Seat 5: elmex886 ($5.17 in chips) 
Seat 6: Epist461 ($6.17 in chips) 
serg430606: posts small blind $0.02
TTPP92: posts big blind $0.05
*** HOLE CARDS ***
Dealt to FakaN4Kavera [6d Qd]
Baikasas: folds 
elmex886: folds 
Epist461: raises $0.06 to $0.11
FakaN4Kavera: folds 
serg430606: folds 
TTPP92: folds 
Uncalled bet ($0.06) returned to Epist461
Epist461 collected $0.12 from pot
Epist461: doesn't show hand 
*** SUMMARY ***
Total pot $0.12 | Rake $0 
Seat 1: FakaN4Kavera (button) folded before Flop (didn't bet)
Seat 2: serg430606 (small blind) folded before Flop
Seat 3: TTPP92 (big blind) folded before Flop
Seat 4: Baikasas folded before Flop (didn't bet)
Seat 5: elmex886 folded before Flop (didn't bet)
Seat 6: Epist461 collected ($0.12)



PokerStars Zoom Hand #257879978375:  Hold'em No Limit ($0.02/$0.05) - 2025/09/25 19:31:40 JST [2025/09/25 6:31:40 ET]
Table 'Donati' 6-max Seat #1 is the button
Seat 1: Baikasas ($5.08 in chips) 
Seat 2: alexnffc1 ($1.53 in chips) 
Seat 3: gio119 ($5 in chips) 
Seat 4: FakaN4Kavera ($7.25 in chips) 
Seat 5: Ingyeoking ($9.52 in chips) 
Seat 6: koshchey_a ($7.32 in chips) 
alexnffc1: posts small blind $0.02
gio119: posts big blind $0.05
*** HOLE CARDS ***
Dealt to FakaN4Kavera [Kh 9s]
FakaN4Kavera: folds 
Ingyeoking: raises $0.05 to $0.10
koshchey_a is disconnected 
koshchey_a has timed out while disconnected
koshchey_a: folds 
Baikasas: folds 
alexnffc1: folds 
gio119: calls $0.05
*** FLOP *** [5s 6s 2s]
gio119: checks 
Ingyeoking: checks 
*** TURN *** [5s 6s 2s] [Tc]
gio119: bets $0.21
Ingyeoking: folds 
Uncalled bet ($0.21) returned to gio119
gio119 collected $0.21 from pot
gio119: doesn't show hand 
*** SUMMARY ***
Total pot $0.22 | Rake $0.01 
Board [5s 6s 2s Tc]
Seat 1: Baikasas (button) folded before Flop (didn't bet)
Seat 2: alexnffc1 (small blind) folded before Flop
Seat 3: gio119 (big blind) collected ($0.21)
Seat 4: FakaN4Kavera folded before Flop (didn't bet)
Seat 5: Ingyeoking folded on the Turn
Seat 6: koshchey_a folded before Flop (didn't bet)



PokerStars Zoom Hand #257879977999:  Hold'em No Limit ($0.02/$0.05) - 2025/09/25 19:31:36 JST [2025/09/25 6:31:36 ET]
Table 'Donati' 6-max Seat #1 is the button
Seat 1: YAG5292 ($4.71 in chips) 
Seat 2: gena60 ($11.63 in chips) 
Seat 3: Irrubikajs ($2.81 in chips) 
Seat 4: 1Kronos ($10.49 in chips) 
Seat 5: FakaN4Kavera ($7.25 in chips) 
Seat 6: alexnffc1 ($1.53 in chips) 
gena60: posts small blind $0.02
Irrubikajs: posts big blind $0.05
*** HOLE CARDS ***
Dealt to FakaN4Kavera [2s 7c]
1Kronos: folds 
FakaN4Kavera: folds 
alexnffc1: folds 
YAG5292: raises $0.09 to $0.14
gena60: folds 
Irrubikajs: calls $0.09
*** FLOP *** [Jh 3d 8h]
Irrubikajs: checks 
YAG5292: bets $0.15
Irrubikajs: calls $0.15
*** TURN *** [Jh 3d 8h] [5h]
Irrubikajs: checks 
YAG5292: bets $0.45
Irrubikajs: raises $0.74 to $1.19
YAG5292: raises $2.28 to $3.47
Irrubikajs: calls $1.33 and is all-in
Uncalled bet ($0.95) returned to YAG5292
*** RIVER *** [Jh 3d 8h 5h] [As]
*** SHOW DOWN ***
Irrubikajs: shows [Qh 6h] (a flush, Queen high)
YAG5292: shows [Js Jc] (three of a kind, Jacks)
Irrubikajs collected $5.41 from pot
*** SUMMARY ***
Total pot $5.64 | Rake $0.23 
Board [Jh 3d 8h 5h As]
Seat 1: YAG5292 (button) showed [Js Jc] and lost with three of a kind, Jacks
Seat 2: gena60 (small blind) folded before Flop
Seat 3: Irrubikajs (big blind) showed [Qh 6h] and won ($5.41) with a flush, Queen high
Seat 4: 1Kronos folded before Flop (didn't bet)
Seat 5: FakaN4Kavera folded before Flop (didn't bet)
Seat 6: alexnffc1 folded before Flop (didn't bet)



PokerStars Zoom Hand #257879981387:  Hold'em No Limit ($0.02/$0.05) - 2025/09/25 19:32:12 JST [2025/09/25 6:32:12 ET]
Table 'Donati' 6-max Seat #1 is the button
Seat 1: dervoigt ($4.43 in chips) 
Seat 2: Ingyeoking ($9.42 in chips) 
Seat 3: zodapoker ($5.76 in chips) 
Seat 4: lebifflemaster ($5.07 in chips) 
Seat 5: 1Kronos ($7.98 in chips) 
Seat 6: FakaN4Kavera ($7.18 in chips) 
Ingyeoking: posts small blind $0.02
zodapoker: posts big blind $0.05
*** HOLE CARDS ***
Dealt to FakaN4Kavera [9h 9s]
lebifflemaster: raises $0.07 to $0.12
1Kronos: folds 
FakaN4Kavera: calls $0.12
dervoigt: folds 
Ingyeoking: folds 
zodapoker: folds 
*** FLOP *** [8d Ks 4s]
lebifflemaster: checks 
FakaN4Kavera: checks 
*** TURN *** [8d Ks 4s] [3d]
lebifflemaster: bets $0.23
FakaN4Kavera: folds 
Uncalled bet ($0.23) returned to lebifflemaster
lebifflemaster collected $0.30 from pot
lebifflemaster: doesn't show hand 
*** SUMMARY ***
Total pot $0.31 | Rake $0.01 
Board [8d Ks 4s 3d]
Seat 1: dervoigt (button) folded before Flop (didn't bet)
Seat 2: Ingyeoking (small blind) folded before Flop
Seat 3: zodapoker (big blind) folded before Flop
Seat 4: lebifflemaster collected ($0.30)
Seat 5: 1Kronos folded before Flop (didn't bet)
Seat 6: FakaN4Kavera folded on the Turn



PokerStars Zoom Hand #257879985073:  Hold'em No Limit ($0.02/$0.05) - 2025/09/25 19:32:51 JST [2025/09/25 6:32:51 ET]
Table 'Donati' 6-max Seat #1 is the button
Seat 1: Ingyeoking ($4.24 in chips) 
Seat 2: zodapoker ($5.71 in chips) 
Seat 3: serg430606 ($5.58 in chips) 
Seat 4: YAG5292 ($10.73 in chips) 
Seat 5: FakaN4Kavera ($7.06 in chips) 
Seat 6: semmely ($5.19 in chips) 
zodapoker: posts small blind $0.02
serg430606: posts big blind $0.05
*** HOLE CARDS ***
Dealt to FakaN4Kavera [Js 8c]
YAG5292: raises $0.09 to $0.14
FakaN4Kavera: folds 
semmely: folds 
Ingyeoking: folds 
zodapoker: folds 
serg430606: folds 
Uncalled bet ($0.09) returned to YAG5292
YAG5292 collected $0.12 from pot
YAG5292: doesn't show hand 
*** SUMMARY ***
Total pot $0.12 | Rake $0 
Seat 1: Ingyeoking (button) folded before Flop (didn't bet)
Seat 2: zodapoker (small blind) folded before Flop
Seat 3: serg430606 (big blind) folded before Flop
Seat 4: YAG5292 collected ($0.12)
Seat 5: FakaN4Kavera folded before Flop (didn't bet)
Seat 6: semmely folded before Flop (didn't bet)



PokerStars Zoom Hand #257879986376:  Hold'em No Limit ($0.02/$0.05) - 2025/09/25 19:33:04 JST [2025/09/25 6:33:04 ET]
Table 'Donati' 6-max Seat #1 is the button
Seat 1: FakaN4Kavera ($7.04 in chips) 
Seat 2: leakleakA ($12.81 in chips) 
Seat 3: 1Kronos ($11.24 in chips) 
Seat 4: Geeuzpeace;) ($5.42 in chips) 
Seat 5: zodapoker ($5.69 in chips) 
Seat 6: scottie4barnes ($8.63 in chips) 
leakleakA: posts small blind $0.02
1Kronos: posts big blind $0.05
*** HOLE CARDS ***
Dealt to FakaN4Kavera [6s 3h]
Geeuzpeace;): folds 
zodapoker: raises $0.07 to $0.12
scottie4barnes: folds 
FakaN4Kavera: folds 
leakleakA: folds 
1Kronos: folds 
Uncalled bet ($0.07) returned to zodapoker
zodapoker collected $0.12 from pot
zodapoker: doesn't show hand 
*** SUMMARY ***
Total pot $0.12 | Rake $0 
Seat 1: FakaN4Kavera (button) folded before Flop (didn't bet)
Seat 2: leakleakA (small blind) folded before Flop
Seat 3: 1Kronos (big blind) folded before Flop
Seat 4: Geeuzpeace;) folded before Flop (didn't bet)
Seat 5: zodapoker collected ($0.12)
Seat 6: scottie4barnes folded before Flop (didn't bet)



PokerStars Zoom Hand #257879987041:  Hold'em No Limit ($0.02/$0.05) - 2025/09/25 19:33:11 JST [2025/09/25 6:33:11 ET]
Table 'Donati' 6-max Seat #1 is the button
Seat 1: gio119 ($5.16 in chips) 
Seat 2: Schöngeist71 ($8.61 in chips) 
Seat 3: scottie4barnes ($8.63 in chips) 
Seat 4: egoor199 ($5.03 in chips) 
Seat 5: Vasco4430 ($9.34 in chips) 
Seat 6: FakaN4Kavera ($7.04 in chips) 
Schöngeist71: posts small blind $0.02
scottie4barnes: posts big blind $0.05
*** HOLE CARDS ***
Dealt to FakaN4Kavera [Ts 5d]
egoor199: folds 
Vasco4430: folds 
FakaN4Kavera: folds 
gio119: folds 
Schöngeist71: raises $0.10 to $0.15
scottie4barnes: folds 
Uncalled bet ($0.10) returned to Schöngeist71
Schöngeist71 collected $0.10 from pot
Schöngeist71: doesn't show hand 
*** SUMMARY ***
Total pot $0.10 | Rake $0 
Seat 1: gio119 (button) folded before Flop (didn't bet)
Seat 2: Schöngeist71 (small blind) collected ($0.10)
Seat 3: scottie4barnes (big blind) folded before Flop
Seat 4: egoor199 folded before Flop (didn't bet)
Seat 5: Vasco4430 folded before Flop (didn't bet)
Seat 6: FakaN4Kavera folded before Flop (didn't bet)



PokerStars Zoom Hand #257879985851:  Hold'em No Limit ($0.02/$0.05) - 2025/09/25 19:32:59 JST [2025/09/25 6:32:59 ET]
Table 'Donati' 6-max Seat #1 is the button
Seat 1: sepik200 ($5.42 in chips) 
Seat 2: FakaN4Kavera ($7.06 in chips) 
Seat 3: kalopara ($4.93 in chips) 
Seat 4: Fercoronas ($4.78 in chips) 
Seat 5: intentii ($5.42 in chips) 
Seat 6: Geeuzpeace;) ($5.42 in chips) 
FakaN4Kavera: posts small blind $0.02
kalopara: posts big blind $0.05
*** HOLE CARDS ***
Dealt to FakaN4Kavera [4d Qh]
Fercoronas: folds 
intentii: folds 
Geeuzpeace;): folds 
sepik200: calls $0.05
FakaN4Kavera: folds 
kalopara: checks 
*** FLOP *** [Ad 3h 5d]
kalopara: checks 
sepik200: bets $0.06
kalopara: calls $0.06
*** TURN *** [Ad 3h 5d] [8c]
kalopara: checks 
sepik200: bets $0.05
kalopara: raises $0.15 to $0.20
sepik200: calls $0.15
*** RIVER *** [Ad 3h 5d 8c] [8s]
kalopara: checks 
sepik200: checks 
*** SHOW DOWN ***
kalopara: shows [Th Ac] (two pair, Aces and Eights)
sepik200: mucks hand 
kalopara collected $0.61 from pot
*** SUMMARY ***
Total pot $0.64 | Rake $0.03 
Board [Ad 3h 5d 8c 8s]
Seat 1: sepik200 (button) mucked [Ah 7d]
Seat 2: FakaN4Kavera (small blind) folded before Flop
Seat 3: kalopara (big blind) showed [Th Ac] and won ($0.61) with two pair, Aces and Eights
Seat 4: Fercoronas folded before Flop (didn't bet)
Seat 5: intentii folded before Flop (didn't bet)
Seat 6: Geeuzpeace;) folded before Flop (didn't bet)



PokerStars Zoom Hand #257879987412:  Hold'em No Limit ($0.02/$0.05) - 2025/09/25 19:33:15 JST [2025/09/25 6:33:15 ET]
Table 'Donati' 6-max Seat #1 is the button
Seat 1: VXNX$157 ($4.10 in chips) 
Seat 2: Epist461 ($6.31 in chips) 
Seat 3: FakaN4Kavera ($7.04 in chips) 
Seat 4: kmc4444 ($6.21 in chips) 
Seat 5: leakleakA ($12.79 in chips) 
Seat 6: Vasco4430 ($9.34 in chips) 
Epist461: posts small blind $0.02
FakaN4Kavera: posts big blind $0.05
*** HOLE CARDS ***
Dealt to FakaN4Kavera [Tc Jc]
kmc4444: folds 
leakleakA: folds 
Vasco4430: folds 
VXNX$157: raises $0.07 to $0.12
Epist461: folds 
FakaN4Kavera: calls $0.07
*** FLOP *** [2s 8s As]
FakaN4Kavera: checks 
VXNX$157: checks 
*** TURN *** [2s 8s As] [4s]
FakaN4Kavera: checks 
VXNX$157: bets $0.08
FakaN4Kavera: folds 
Uncalled bet ($0.08) returned to VXNX$157
VXNX$157 collected $0.25 from pot
VXNX$157: doesn't show hand 
*** SUMMARY ***
Total pot $0.26 | Rake $0.01 
Board [2s 8s As 4s]
Seat 1: VXNX$157 (button) collected ($0.25)
Seat 2: Epist461 (small blind) folded before Flop
Seat 3: FakaN4Kavera (big blind) folded on the Turn
Seat 4: kmc4444 folded before Flop (didn't bet)
Seat 5: leakleakA folded before Flop (didn't bet)
Seat 6: Vasco4430 folded before Flop (didn't bet)



PokerStars Zoom Hand #257879992821:  Hold'em No Limit ($0.02/$0.05) - 2025/09/25 19:34:10 JST [2025/09/25 6:34:10 ET]
Table 'Donati' 6-max Seat #1 is the button
Seat 1: YAG5292 ($9.03 in chips) 
Seat 2: gio119 ($5.03 in chips) 
Seat 3: FakaN4Kavera ($6.90 in chips) 
Seat 4: kmc4444 ($5.18 in chips) 
Seat 5: kalopara ($4.46 in chips) 
Seat 6: 3rdguess ($5.07 in chips) 
gio119: posts small blind $0.02
FakaN4Kavera: posts big blind $0.05
*** HOLE CARDS ***
Dealt to FakaN4Kavera [9c 3d]
kmc4444: folds 
kalopara: folds 
3rdguess: folds 
YAG5292: raises $0.09 to $0.14
gio119: folds 
FakaN4Kavera: folds 
Uncalled bet ($0.09) returned to YAG5292
YAG5292 collected $0.12 from pot
YAG5292: doesn't show hand 
*** SUMMARY ***
Total pot $0.12 | Rake $0 
Seat 1: YAG5292 (button) collected ($0.12)
Seat 2: gio119 (small blind) folded before Flop
Seat 3: FakaN4Kavera (big blind) folded before Flop
Seat 4: kmc4444 folded before Flop (didn't bet)
Seat 5: kalopara folded before Flop (didn't bet)
Seat 6: 3rdguess folded before Flop (didn't bet)



PokerStars Zoom Hand #257879991960:  Hold'em No Limit ($0.02/$0.05) - 2025/09/25 19:34:01 JST [2025/09/25 6:34:01 ET]
Table 'Donati' 6-max Seat #1 is the button
Seat 1: 1Kronos ($10.50 in chips) 
Seat 2: lebifflemaster ($8.11 in chips) 
Seat 3: TTPP92 ($4.84 in chips) 
Seat 4: gena60 ($10.44 in chips) 
Seat 5: VXNX$157 ($4.23 in chips) 
Seat 6: FakaN4Kavera ($6.92 in chips) 
lebifflemaster: posts small blind $0.02
TTPP92: posts big blind $0.05
*** HOLE CARDS ***
Dealt to FakaN4Kavera [Qs 4s]
gena60: folds 
VXNX$157: raises $0.05 to $0.10
FakaN4Kavera: folds 
1Kronos: folds 
lebifflemaster: folds 
TTPP92: calls $0.05
*** FLOP *** [7h 8s 3c]
TTPP92: checks 
VXNX$157: bets $0.14
TTPP92: folds 
Uncalled bet ($0.14) returned to VXNX$157
VXNX$157 collected $0.21 from pot
VXNX$157: doesn't show hand 
*** SUMMARY ***
Total pot $0.22 | Rake $0.01 
Board [7h 8s 3c]
Seat 1: 1Kronos (button) folded before Flop (didn't bet)
Seat 2: lebifflemaster (small blind) folded before Flop
Seat 3: TTPP92 (big blind) folded on the Flop
Seat 4: gena60 folded before Flop (didn't bet)
Seat 5: VXNX$157 collected ($0.21)
Seat 6: FakaN4Kavera folded before Flop (didn't bet)



PokerStars Zoom Hand #257879990882:  Hold'em No Limit ($0.02/$0.05) - 2025/09/25 19:33:50 JST [2025/09/25 6:33:50 ET]
Table 'Donati' 6-max Seat #1 is the button
Seat 1: intentii ($5.59 in chips) 
Seat 2: leakleakA ($12.74 in chips) 
Seat 3: Ingyeoking ($1.85 in chips) 
Seat 4: elmex886 ($5.17 in chips) 
Seat 5: FakaN4Kavera ($6.92 in chips) 
Seat 6: franks270 ($7.50 in chips) 
leakleakA: posts small blind $0.02
Ingyeoking: posts big blind $0.05
*** HOLE CARDS ***
Dealt to FakaN4Kavera [Ts Kd]
elmex886: raises $0.10 to $0.15
FakaN4Kavera: folds 
franks270: calls $0.15
intentii: folds 
leakleakA: folds 
Ingyeoking: raises $1.70 to $1.85 and is all-in
elmex886: folds 
franks270: calls $1.70
*** FLOP *** [Qc 7c 5h]
*** TURN *** [Qc 7c 5h] [Qd]
*** RIVER *** [Qc 7c 5h Qd] [6d]
*** SHOW DOWN ***
Ingyeoking: shows [Ah 8h] (a pair of Queens)
franks270: shows [3c 3h] (two pair, Queens and Threes)
franks270 collected $3.71 from pot
*** SUMMARY ***
Total pot $3.87 | Rake $0.16 
Board [Qc 7c 5h Qd 6d]
Seat 1: intentii (button) folded before Flop (didn't bet)
Seat 2: leakleakA (small blind) folded before Flop
Seat 3: Ingyeoking (big blind) showed [Ah 8h] and lost with a pair of Queens
Seat 4: elmex886 folded before Flop
Seat 5: FakaN4Kavera folded before Flop (didn't bet)
Seat 6: franks270 showed [3c 3h] and won ($3.71) with two pair, Queens and Threes



PokerStars Zoom Hand #257879991540:  Hold'em No Limit ($0.02/$0.05) - 2025/09/25 19:33:57 JST [2025/09/25 6:33:57 ET]
Table 'Donati' 6-max Seat #1 is the button
Seat 1: Fercoronas ($4.71 in chips) 
Seat 2: kalopara ($4.48 in chips) 
Seat 3: alexnffc1 ($1.27 in chips) 
Seat 4: FakaN4Kavera ($6.92 in chips) 
Seat 5: Schöngeist71 ($8.80 in chips) 
Seat 6: kmc4444 ($5 in chips) 
kalopara: posts small blind $0.02
alexnffc1: posts big blind $0.05
*** HOLE CARDS ***
Dealt to FakaN4Kavera [2s 9s]
FakaN4Kavera: folds 
Schöngeist71: raises $0.05 to $0.10
kmc4444: folds 
Fercoronas: folds 
kalopara: folds 
alexnffc1: calls $0.05
*** FLOP *** [Jc Th As]
alexnffc1: checks 
Schöngeist71: bets $0.05
alexnffc1: calls $0.05
*** TURN *** [Jc Th As] [Kd]
alexnffc1: checks 
Schöngeist71: bets $0.10
alexnffc1: calls $0.10
*** RIVER *** [Jc Th As Kd] [Ah]
alexnffc1: checks 
Schöngeist71: bets $8.55 and is all-in
alexnffc1: calls $1.02 and is all-in
Uncalled bet ($7.53) returned to Schöngeist71
*** SHOW DOWN ***
Schöngeist71: shows [Kc Ks] (a full house, Kings full of Aces)
alexnffc1: shows [Td Qd] (a straight, Ten to Ace)
Schöngeist71 collected $2.42 from pot
*** SUMMARY ***
Total pot $2.56 | Rake $0.14 
Board [Jc Th As Kd Ah]
Seat 1: Fercoronas (button) folded before Flop (didn't bet)
Seat 2: kalopara (small blind) folded before Flop
Seat 3: alexnffc1 (big blind) showed [Td Qd] and lost with a straight, Ten to Ace
Seat 4: FakaN4Kavera folded before Flop (didn't bet)
Seat 5: Schöngeist71 showed [Kc Ks] and won ($2.42) with a full house, Kings full of Aces
Seat 6: kmc4444 folded before Flop (didn't bet)



PokerStars Zoom Hand #257879994144:  Hold'em No Limit ($0.02/$0.05) - 2025/09/25 19:34:23 JST [2025/09/25 6:34:23 ET]
Table 'Donati' 6-max Seat #1 is the button
Seat 1: FakaN4Kavera ($6.85 in chips) 
Seat 2: hugoreisssss ($4.82 in chips) 
Seat 3: dervoigt ($4.04 in chips) 
Seat 4: kmc4444 ($5.16 in chips) 
Seat 5: YAG5292 ($10.53 in chips) 
Seat 6: gio119 ($5.15 in chips) 
hugoreisssss: posts small blind $0.02
dervoigt: posts big blind $0.05
*** HOLE CARDS ***
Dealt to FakaN4Kavera [Ad Kh]
kmc4444: folds 
YAG5292: folds 
gio119: folds 
FakaN4Kavera: raises $0.07 to $0.12
hugoreisssss: folds 
dervoigt: calls $0.07
*** FLOP *** [Kc 9s 4d]
dervoigt: checks 
FakaN4Kavera: bets $0.13
dervoigt: folds 
Uncalled bet ($0.13) returned to FakaN4Kavera
FakaN4Kavera collected $0.25 from pot
FakaN4Kavera: doesn't show hand 
*** SUMMARY ***
Total pot $0.26 | Rake $0.01 
Board [Kc 9s 4d]
Seat 1: FakaN4Kavera (button) collected ($0.25)
Seat 2: hugoreisssss (small blind) folded before Flop
Seat 3: dervoigt (big blind) folded on the Flop
Seat 4: kmc4444 folded before Flop (didn't bet)
Seat 5: YAG5292 folded before Flop (didn't bet)
Seat 6: gio119 folded before Flop (didn't bet)



PokerStars Zoom Hand #257879992338:  Hold'em No Limit ($0.02/$0.05) - 2025/09/25 19:34:05 JST [2025/09/25 6:34:05 ET]
Table 'Donati' 6-max Seat #1 is the button
Seat 1: serg430606 ($5.53 in chips) 
Seat 2: FakaN4Kavera ($6.92 in chips) 
Seat 3: intentii ($5 in chips) 
Seat 4: 3rdguess ($5.07 in chips) 
Seat 5: Fercoronas ($4.71 in chips) 
Seat 6: emmachan415 ($5.17 in chips) 
FakaN4Kavera: posts small blind $0.02
intentii: posts big blind $0.05
*** HOLE CARDS ***
Dealt to FakaN4Kavera [As 2h]
3rdguess: folds 
Fercoronas: folds 
emmachan415: folds 
serg430606: raises $0.10 to $0.15
FakaN4Kavera: folds 
intentii: calls $0.10
*** FLOP *** [Ah 9s Qh]
intentii: checks 
serg430606: checks 
*** TURN *** [Ah 9s Qh] [Tc]
intentii: bets $0.23
serg430606: folds 
Uncalled bet ($0.23) returned to intentii
intentii collected $0.31 from pot
intentii: doesn't show hand 
*** SUMMARY ***
Total pot $0.32 | Rake $0.01 
Board [Ah 9s Qh Tc]
Seat 1: serg430606 (button) folded on the Turn
Seat 2: FakaN4Kavera (small blind) folded before Flop
Seat 3: intentii (big blind) collected ($0.31)
Seat 4: 3rdguess folded before Flop (didn't bet)
Seat 5: Fercoronas folded before Flop (didn't bet)
Seat 6: emmachan415 folded before Flop (didn't bet)



PokerStars Zoom Hand #257879997117:  Hold'em No Limit ($0.02/$0.05) - 2025/09/25 19:34:53 JST [2025/09/25 6:34:53 ET]
Table 'Donati' 6-max Seat #1 is the button
Seat 1: YAG5292 ($9.03 in chips) 
Seat 2: cherry006 ($5.07 in chips) 
Seat 3: zodapoker ($4.66 in chips) 
Seat 4: FakaN4Kavera ($6.98 in chips) 
Seat 5: Baikasas ($6.15 in chips) 
Seat 6: leakleakA ($12.77 in chips) 
cherry006: posts small blind $0.02
zodapoker: posts big blind $0.05
*** HOLE CARDS ***
Dealt to FakaN4Kavera [Ah 2h]
FakaN4Kavera: raises $0.07 to $0.12
Baikasas: folds 
leakleakA: raises $0.26 to $0.38
YAG5292: folds 
cherry006: folds 
zodapoker: folds 
FakaN4Kavera: folds 
Uncalled bet ($0.26) returned to leakleakA
leakleakA collected $0.31 from pot
leakleakA: doesn't show hand 
*** SUMMARY ***
Total pot $0.31 | Rake $0 
Seat 1: YAG5292 (button) folded before Flop (didn't bet)
Seat 2: cherry006 (small blind) folded before Flop
Seat 3: zodapoker (big blind) folded before Flop
Seat 4: FakaN4Kavera folded before Flop
Seat 5: Baikasas folded before Flop (didn't bet)
Seat 6: leakleakA collected ($0.31)



PokerStars Zoom Hand #257879999640:  Hold'em No Limit ($0.02/$0.05) - 2025/09/25 19:35:20 JST [2025/09/25 6:35:20 ET]
Table 'Donati' 6-max Seat #1 is the button
Seat 1: Miss Turbo G ($4.95 in chips) 
Seat 2: Baikasas ($5 in chips) 
Seat 3: faithfulness ($5.07 in chips) 
Seat 4: cherry006 ($5.05 in chips) 
Seat 5: sepik200 ($5.07 in chips) 
Seat 6: FakaN4Kavera ($6.86 in chips) 
Baikasas: posts small blind $0.02
faithfulness: posts big blind $0.05
*** HOLE CARDS ***
Dealt to FakaN4Kavera [Ac Qs]
cherry006: folds 
sepik200: folds 
FakaN4Kavera: raises $0.07 to $0.12
Miss Turbo G: folds 
Baikasas: folds 
faithfulness: folds 
Uncalled bet ($0.07) returned to FakaN4Kavera
FakaN4Kavera collected $0.12 from pot
FakaN4Kavera: doesn't show hand 
*** SUMMARY ***
Total pot $0.12 | Rake $0 
Seat 1: Miss Turbo G (button) folded before Flop (didn't bet)
Seat 2: Baikasas (small blind) folded before Flop
Seat 3: faithfulness (big blind) folded before Flop
Seat 4: cherry006 folded before Flop (didn't bet)
Seat 5: sepik200 folded before Flop (didn't bet)
Seat 6: FakaN4Kavera collected ($0.12)



PokerStars Zoom Hand #257879996520:  Hold'em No Limit ($0.02/$0.05) - 2025/09/25 19:34:47 JST [2025/09/25 6:34:47 ET]
Table 'Donati' 6-max Seat #1 is the button
Seat 1: gena60 ($10.37 in chips) 
Seat 2: zodapoker ($6.79 in chips) 
Seat 3: gio119 ($5.01 in chips) 
Seat 4: Irrubikajs ($5.84 in chips) 
Seat 5: FakaN4Kavera ($6.98 in chips) 
Seat 6: dervoigt ($3.92 in chips) 
zodapoker: posts small blind $0.02
gio119: posts big blind $0.05
*** HOLE CARDS ***
Dealt to FakaN4Kavera [5c 4h]
Irrubikajs: folds 
FakaN4Kavera: folds 
dervoigt: folds 
gena60: folds 
zodapoker: raises $0.07 to $0.12
gio119: calls $0.07
*** FLOP *** [4d 6d Qs]
zodapoker: checks 
gio119: checks 
*** TURN *** [4d 6d Qs] [9s]
zodapoker: checks 
gio119: checks 
*** RIVER *** [4d 6d Qs 9s] [5d]
zodapoker: checks 
gio119: bets $0.23
zodapoker: folds 
Uncalled bet ($0.23) returned to gio119
gio119 collected $0.23 from pot
gio119: doesn't show hand 
*** SUMMARY ***
Total pot $0.24 | Rake $0.01 
Board [4d 6d Qs 9s 5d]
Seat 1: gena60 (button) folded before Flop (didn't bet)
Seat 2: zodapoker (small blind) folded on the River
Seat 3: gio119 (big blind) collected ($0.23)
Seat 4: Irrubikajs folded before Flop (didn't bet)
Seat 5: FakaN4Kavera folded before Flop (didn't bet)
Seat 6: dervoigt folded before Flop (didn't bet)



PokerStars Zoom Hand #257879996829:  Hold'em No Limit ($0.02/$0.05) - 2025/09/25 19:34:50 JST [2025/09/25 6:34:50 ET]
Table 'Donati' 6-max Seat #1 is the button
Seat 1: 1Kronos ($8.62 in chips) 
Seat 2: Epist461 ($6.43 in chips) 
Seat 3: TTPP92 ($4.72 in chips) 
Seat 4: FakaN4Kavera ($6.98 in chips) 
Seat 5: Vasco4430 ($9.64 in chips) 
Seat 6: intentii ($5.16 in chips) 
Epist461: posts small blind $0.02
TTPP92: posts big blind $0.05
*** HOLE CARDS ***
Dealt to FakaN4Kavera [Qd 8d]
FakaN4Kavera: folds 
Vasco4430: raises $0.10 to $0.15
intentii: folds 
1Kronos: folds 
Epist461: folds 
TTPP92: calls $0.10
*** FLOP *** [7c 7d 2h]
TTPP92: checks 
Vasco4430: bets $0.16
TTPP92: calls $0.16
*** TURN *** [7c 7d 2h] [Jh]
TTPP92: checks 
Vasco4430: bets $0.31
TTPP92: folds 
Uncalled bet ($0.31) returned to Vasco4430
Vasco4430 collected $0.61 from pot
Vasco4430: doesn't show hand 
*** SUMMARY ***
Total pot $0.64 | Rake $0.03 
Board [7c 7d 2h Jh]
Seat 1: 1Kronos (button) folded before Flop (didn't bet)
Seat 2: Epist461 (small blind) folded before Flop
Seat 3: TTPP92 (big blind) folded on the Turn
Seat 4: FakaN4Kavera folded before Flop (didn't bet)
Seat 5: Vasco4430 collected ($0.61)
Seat 6: intentii folded before Flop (didn't bet)



PokerStars Zoom Hand #257880001686:  Hold'em No Limit ($0.02/$0.05) - 2025/09/25 19:35:41 JST [2025/09/25 6:35:41 ET]
Table 'Donati' 6-max Seat #1 is the button
Seat 1: Geeuzpeace;) ($4.91 in chips) 
Seat 2: zodapoker ($4.61 in chips) 
Seat 3: FakaN4Kavera ($6.93 in chips) 
Seat 4: leakleakA ($12.94 in chips) 
Seat 5: delfinato200 ($14.41 in chips) 
Seat 6: Baikasas ($5 in chips) 
zodapoker: posts small blind $0.02
FakaN4Kavera: posts big blind $0.05
*** HOLE CARDS ***
Dealt to FakaN4Kavera [Js Qc]
leakleakA: folds 
delfinato200: calls $0.05
Baikasas: folds 
Geeuzpeace;): calls $0.05
zodapoker: calls $0.03
FakaN4Kavera: checks 
*** FLOP *** [3s Ac Ah]
zodapoker: checks 
FakaN4Kavera: checks 
delfinato200: checks 
Geeuzpeace;): checks 
*** TURN *** [3s Ac Ah] [5c]
zodapoker: checks 
FakaN4Kavera: checks 
delfinato200: bets $0.05
Geeuzpeace;): calls $0.05
zodapoker: folds 
FakaN4Kavera: folds 
*** RIVER *** [3s Ac Ah 5c] [Qh]
delfinato200: checks 
Geeuzpeace;): bets $0.29
delfinato200: folds 
Uncalled bet ($0.29) returned to Geeuzpeace;)
Geeuzpeace;) collected $0.29 from pot
Geeuzpeace;): doesn't show hand 
*** SUMMARY ***
Total pot $0.30 | Rake $0.01 
Board [3s Ac Ah 5c Qh]
Seat 1: Geeuzpeace;) (button) collected ($0.29)
Seat 2: zodapoker (small blind) folded on the Turn
Seat 3: FakaN4Kavera (big blind) folded on the Turn
Seat 4: leakleakA folded before Flop (didn't bet)
Seat 5: delfinato200 folded on the River
Seat 6: Baikasas folded before Flop (didn't bet)



PokerStars Zoom Hand #257880006230:  Hold'em No Limit ($0.02/$0.05) - 2025/09/25 19:36:27 JST [2025/09/25 6:36:27 ET]
Table 'Donati' 6-max Seat #1 is the button
Seat 1: FakaN4Kavera ($6.86 in chips) 
Seat 2: leakleakA ($12.96 in chips) 
Seat 3: goaßmaß-fips ($14.42 in chips) 
Seat 4: 1Kronos ($10.31 in chips) 
Seat 5: coolDadJimbo ($5.58 in chips) 
Seat 6: Ingyeoking ($4.44 in chips) 
leakleakA: posts small blind $0.02
goaßmaß-fips: posts big blind $0.05
*** HOLE CARDS ***
Dealt to FakaN4Kavera [5c Ts]
1Kronos: folds 
coolDadJimbo: folds 
Ingyeoking: folds 
FakaN4Kavera: folds 
leakleakA: folds 
Uncalled bet ($0.03) returned to goaßmaß-fips
goaßmaß-fips collected $0.04 from pot
goaßmaß-fips: doesn't show hand 
*** SUMMARY ***
Total pot $0.04 | Rake $0 
Seat 1: FakaN4Kavera (button) folded before Flop (didn't bet)
Seat 2: leakleakA (small blind) folded before Flop
Seat 3: goaßmaß-fips (big blind) collected ($0.04)
Seat 4: 1Kronos folded before Flop (didn't bet)
Seat 5: coolDadJimbo folded before Flop (didn't bet)
Seat 6: Ingyeoking folded before Flop (didn't bet)



PokerStars Zoom Hand #257880006885:  Hold'em No Limit ($0.02/$0.05) - 2025/09/25 19:36:34 JST [2025/09/25 6:36:34 ET]
Table 'Donati' 6-max Seat #1 is the button
Seat 1: hugoreisssss ($4.79 in chips) 
Seat 2: FakaN4Kavera ($6.86 in chips) 
Seat 3: YAG5292 ($2.09 in chips) 
Seat 4: Ingyeoking ($4.44 in chips) 
Seat 5: faithfulness ($5 in chips) 
Seat 6: kmc4444 ($6.51 in chips) 
FakaN4Kavera: posts small blind $0.02
YAG5292: posts big blind $0.05
*** HOLE CARDS ***
Dealt to FakaN4Kavera [7d 7s]
Ingyeoking: folds 
faithfulness: folds 
kmc4444: folds 
hugoreisssss: folds 
FakaN4Kavera: raises $0.07 to $0.12
YAG5292: folds 
Uncalled bet ($0.07) returned to FakaN4Kavera
FakaN4Kavera collected $0.10 from pot
FakaN4Kavera: doesn't show hand 
*** SUMMARY ***
Total pot $0.10 | Rake $0 
Seat 1: hugoreisssss (button) folded before Flop (didn't bet)
Seat 2: FakaN4Kavera (small blind) collected ($0.10)
Seat 3: YAG5292 (big blind) folded before Flop
Seat 4: Ingyeoking folded before Flop (didn't bet)
Seat 5: faithfulness folded before Flop (didn't bet)
Seat 6: kmc4444 folded before Flop (didn't bet)



PokerStars Zoom Hand #257880005132:  Hold'em No Limit ($0.02/$0.05) - 2025/09/25 19:36:16 JST [2025/09/25 6:36:16 ET]
Table 'Donati' 6-max Seat #1 is the button
Seat 1: gio119 ($5.10 in chips) 
Seat 2: FakaN4Kavera ($6.88 in chips) 
Seat 3: zodapoker ($4.56 in chips) 
Seat 4: egoor199 ($5.16 in chips) 
Seat 5: kalopara ($4.58 in chips) 
Seat 6: huyjokezy ($5.91 in chips) 
FakaN4Kavera: posts small blind $0.02
zodapoker: posts big blind $0.05
*** HOLE CARDS ***
Dealt to FakaN4Kavera [Ad Jh]
egoor199: folds 
kalopara: folds 
huyjokezy: raises $0.10 to $0.15
gio119 has timed out
gio119: folds 
FakaN4Kavera: folds 
zodapoker: folds 
Uncalled bet ($0.10) returned to huyjokezy
huyjokezy collected $0.12 from pot
huyjokezy: doesn't show hand 
*** SUMMARY ***
Total pot $0.12 | Rake $0 
Seat 1: gio119 (button) folded before Flop (didn't bet)
Seat 2: FakaN4Kavera (small blind) folded before Flop
Seat 3: zodapoker (big blind) folded before Flop
Seat 4: egoor199 folded before Flop (didn't bet)
Seat 5: kalopara folded before Flop (didn't bet)
Seat 6: huyjokezy collected ($0.12)



PokerStars Zoom Hand #257880009779:  Hold'em No Limit ($0.02/$0.05) - 2025/09/25 19:37:03 JST [2025/09/25 6:37:03 ET]
Table 'Donati' 6-max Seat #1 is the button
Seat 1: IBRODIAN-ACER ($5 in chips) 
Seat 2: ICallForYou ($3.95 in chips) 
Seat 3: 1Kronos ($12.33 in chips) 
Seat 4: YAG5292 ($8.38 in chips) 
Seat 5: Kenbunshoku ($2.25 in chips) 
Seat 6: FakaN4Kavera ($6.91 in chips) 
ICallForYou: posts small blind $0.02
1Kronos: posts big blind $0.05
*** HOLE CARDS ***
Dealt to FakaN4Kavera [9c 8d]
YAG5292: folds 
Kenbunshoku: folds 
FakaN4Kavera: folds 
IBRODIAN-ACER: folds 
ICallForYou: folds 
Uncalled bet ($0.03) returned to 1Kronos
1Kronos collected $0.04 from pot
1Kronos: doesn't show hand 
*** SUMMARY ***
Total pot $0.04 | Rake $0 
Seat 1: IBRODIAN-ACER (button) folded before Flop (didn't bet)
Seat 2: ICallForYou (small blind) folded before Flop
Seat 3: 1Kronos (big blind) collected ($0.04)
Seat 4: YAG5292 folded before Flop (didn't bet)
Seat 5: Kenbunshoku folded before Flop (didn't bet)
Seat 6: FakaN4Kavera folded before Flop (didn't bet)



PokerStars Zoom Hand #257880009185:  Hold'em No Limit ($0.02/$0.05) - 2025/09/25 19:36:57 JST [2025/09/25 6:36:57 ET]
Table 'Donati' 6-max Seat #1 is the button
Seat 1: FakaN4Kavera ($6.91 in chips) 
Seat 2: faithfulness ($5.19 in chips) 
Seat 3: Epist461 ($6.54 in chips) 
Seat 4: Vasco4430 ($9.79 in chips) 
Seat 5: BretticusX ($5.27 in chips) 
Seat 6: YAG5292 ($2.04 in chips) 
faithfulness: posts small blind $0.02
Epist461: posts big blind $0.05
*** HOLE CARDS ***
Dealt to FakaN4Kavera [Td 6h]
Vasco4430: raises $0.10 to $0.15
BretticusX: folds 
YAG5292: folds 
FakaN4Kavera: folds 
faithfulness: folds 
Epist461: folds 
Uncalled bet ($0.10) returned to Vasco4430
Vasco4430 collected $0.12 from pot
Vasco4430: doesn't show hand 
*** SUMMARY ***
Total pot $0.12 | Rake $0 
Seat 1: FakaN4Kavera (button) folded before Flop (didn't bet)
Seat 2: faithfulness (small blind) folded before Flop
Seat 3: Epist461 (big blind) folded before Flop
Seat 4: Vasco4430 collected ($0.12)
Seat 5: BretticusX folded before Flop (didn't bet)
Seat 6: YAG5292 folded before Flop (didn't bet)



PokerStars Zoom Hand #257880006605:  Hold'em No Limit ($0.02/$0.05) - 2025/09/25 19:36:31 JST [2025/09/25 6:36:31 ET]
Table 'Donati' 6-max Seat #1 is the button
Seat 1: lebifflemaster ($7.52 in chips) 
Seat 2: YAG5292 ($5.55 in chips) 
Seat 3: VXNX$157 ($4.24 in chips) 
Seat 4: FakaN4Kavera ($6.86 in chips) 
Seat 5: Geeuzpeace;) ($5.10 in chips) 
Seat 6: Schöngeist71 ($10.35 in chips) 
YAG5292: posts small blind $0.02
VXNX$157: posts big blind $0.05
*** HOLE CARDS ***
Dealt to FakaN4Kavera [3c 3s]
FakaN4Kavera: folds 
Geeuzpeace;): calls $0.05
Schöngeist71: folds 
lebifflemaster: folds 
YAG5292: raises $0.12 to $0.17
VXNX$157: folds 
Geeuzpeace;): calls $0.12
*** FLOP *** [2d 8d 4s]
YAG5292: checks 
Geeuzpeace;): bets $0.05
YAG5292: calls $0.05
*** TURN *** [2d 8d 4s] [2h]
YAG5292: checks 
Geeuzpeace;): bets $0.15
YAG5292: folds 
Uncalled bet ($0.15) returned to Geeuzpeace;)
Geeuzpeace;) collected $0.47 from pot
Geeuzpeace;): doesn't show hand 
*** SUMMARY ***
Total pot $0.49 | Rake $0.02 
Board [2d 8d 4s 2h]
Seat 1: lebifflemaster (button) folded before Flop (didn't bet)
Seat 2: YAG5292 (small blind) folded on the Turn
Seat 3: VXNX$157 (big blind) folded before Flop
Seat 4: FakaN4Kavera folded before Flop (didn't bet)
Seat 5: Geeuzpeace;) collected ($0.47)
Seat 6: Schöngeist71 folded before Flop (didn't bet)



PokerStars Zoom Hand #257880010779:  Hold'em No Limit ($0.02/$0.05) - 2025/09/25 19:37:13 JST [2025/09/25 6:37:13 ET]
Table 'Donati' 6-max Seat #1 is the button
Seat 1: kalopara ($3.60 in chips) 
Seat 2: 1Kronos ($8.94 in chips) 
Seat 3: FakaN4Kavera ($6.91 in chips) 
Seat 4: zodapoker ($6.81 in chips) 
Seat 5: huyjokezy ($5 in chips) 
Seat 6: cherry006 ($4.22 in chips) 
1Kronos: posts small blind $0.02
FakaN4Kavera: posts big blind $0.05
*** HOLE CARDS ***
Dealt to FakaN4Kavera [9c Kc]
zodapoker: folds 
huyjokezy: folds 
cherry006: folds 
kalopara: folds 
1Kronos: raises $0.10 to $0.15
FakaN4Kavera: calls $0.10
*** FLOP *** [Ah Qc 2h]
1Kronos: checks 
FakaN4Kavera: checks 
*** TURN *** [Ah Qc 2h] [6h]
1Kronos: checks 
FakaN4Kavera: checks 
*** RIVER *** [Ah Qc 2h 6h] [7s]
1Kronos: bets $0.10
FakaN4Kavera: folds 
Uncalled bet ($0.10) returned to 1Kronos
1Kronos collected $0.29 from pot
1Kronos: doesn't show hand 
*** SUMMARY ***
Total pot $0.30 | Rake $0.01 
Board [Ah Qc 2h 6h 7s]
Seat 1: kalopara (button) folded before Flop (didn't bet)
Seat 2: 1Kronos (small blind) collected ($0.29)
Seat 3: FakaN4Kavera (big blind) folded on the River
Seat 4: zodapoker folded before Flop (didn't bet)
Seat 5: huyjokezy folded before Flop (didn't bet)
Seat 6: cherry006 folded before Flop (didn't bet)



PokerStars Zoom Hand #257880017896:  Hold'em No Limit ($0.02/$0.05) - 2025/09/25 19:38:24 JST [2025/09/25 6:38:24 ET]
Table 'Donati' 6-max Seat #1 is the button
Seat 1: Miss Turbo G ($6.02 in chips) 
Seat 2: FakaN4Kavera ($6.76 in chips) 
Seat 3: intentii ($6.73 in chips) 
Seat 4: IBRODIAN-ACER ($5.14 in chips) 
Seat 5: faithfulness ($5.05 in chips) 
Seat 6: alpaz01 ($5.65 in chips) 
FakaN4Kavera: posts small blind $0.02
intentii: posts big blind $0.05
*** HOLE CARDS ***
Dealt to FakaN4Kavera [8d 2d]
IBRODIAN-ACER: folds 
faithfulness: folds 
alpaz01: folds 
Miss Turbo G: folds 
FakaN4Kavera: folds 
Uncalled bet ($0.03) returned to intentii
intentii collected $0.04 from pot
intentii: doesn't show hand 
*** SUMMARY ***
Total pot $0.04 | Rake $0 
Seat 1: Miss Turbo G (button) folded before Flop (didn't bet)
Seat 2: FakaN4Kavera (small blind) folded before Flop
Seat 3: intentii (big blind) collected ($0.04)
Seat 4: IBRODIAN-ACER folded before Flop (didn't bet)
Seat 5: faithfulness folded before Flop (didn't bet)
Seat 6: alpaz01 folded before Flop (didn't bet)



PokerStars Zoom Hand #257880018980:  Hold'em No Limit ($0.02/$0.05) - 2025/09/25 19:38:35 JST [2025/09/25 6:38:35 ET]
Table 'Donati' 6-max Seat #1 is the button
Seat 1: kalopara ($4.13 in chips) 
Seat 2: zodapoker ($7.07 in chips) 
Seat 3: FakaN4Kavera ($6.74 in chips) 
Seat 4: huyjokezy ($5 in chips) 
Seat 5: titeuf3012 ($4.21 in chips) 
Seat 6: semmely ($9.36 in chips) 
zodapoker: posts small blind $0.02
FakaN4Kavera: posts big blind $0.05
*** HOLE CARDS ***
Dealt to FakaN4Kavera [6s 2c]
huyjokezy: folds 
titeuf3012: folds 
semmely: folds 
kalopara: folds 
zodapoker: folds 
Uncalled bet ($0.03) returned to FakaN4Kavera
FakaN4Kavera collected $0.04 from pot
FakaN4Kavera: doesn't show hand 
*** SUMMARY ***
Total pot $0.04 | Rake $0 
Seat 1: kalopara (button) folded before Flop (didn't bet)
Seat 2: zodapoker (small blind) folded before Flop
Seat 3: FakaN4Kavera (big blind) collected ($0.04)
Seat 4: huyjokezy folded before Flop (didn't bet)
Seat 5: titeuf3012 folded before Flop (didn't bet)
Seat 6: semmely folded before Flop (didn't bet)



PokerStars Zoom Hand #257880018394:  Hold'em No Limit ($0.02/$0.05) - 2025/09/25 19:38:29 JST [2025/09/25 6:38:29 ET]
Table 'Donati' 6-max Seat #1 is the button
Seat 1: zodapoker ($7.07 in chips) 
Seat 2: Megam181 ($3.02 in chips) 
Seat 3: faithfulness ($5.05 in chips) 
Seat 4: Ingyeoking ($10.11 in chips) 
Seat 5: FakaN4Kavera ($6.74 in chips) 
Seat 6: KRSofM ($4.93 in chips) 
Megam181: posts small blind $0.02
faithfulness: posts big blind $0.05
*** HOLE CARDS ***
Dealt to FakaN4Kavera [2c 2s]
Ingyeoking: folds 
FakaN4Kavera: folds 
KRSofM: raises $0.07 to $0.12
zodapoker: folds 
Megam181: folds 
faithfulness: folds 
Uncalled bet ($0.07) returned to KRSofM
KRSofM collected $0.12 from pot
KRSofM: doesn't show hand 
*** SUMMARY ***
Total pot $0.12 | Rake $0 
Seat 1: zodapoker (button) folded before Flop (didn't bet)
Seat 2: Megam181 (small blind) folded before Flop
Seat 3: faithfulness (big blind) folded before Flop
Seat 4: Ingyeoking folded before Flop (didn't bet)
Seat 5: FakaN4Kavera folded before Flop (didn't bet)
Seat 6: KRSofM collected ($0.12)



PokerStars Zoom Hand #257880017318:  Hold'em No Limit ($0.02/$0.05) - 2025/09/25 19:38:18 JST [2025/09/25 6:38:18 ET]
Table 'Donati' 6-max Seat #1 is the button
Seat 1: FakaN4Kavera ($6.76 in chips) 
Seat 2: Ingyeoking ($5.04 in chips) 
Seat 3: faithfulness ($5 in chips) 
Seat 4: sepik200 ($4.85 in chips) 
Seat 5: Kenbunshoku ($4.98 in chips) 
Seat 6: cherry006 ($4.03 in chips) 
Ingyeoking: posts small blind $0.02
faithfulness: posts big blind $0.05
*** HOLE CARDS ***
Dealt to FakaN4Kavera [Qd 8d]
sepik200: calls $0.05
Kenbunshoku: folds 
cherry006: folds 
FakaN4Kavera: folds 
Ingyeoking: folds 
faithfulness: checks 
*** FLOP *** [Jh 3c Kc]
faithfulness: checks 
sepik200: checks 
*** TURN *** [Jh 3c Kc] [2s]
faithfulness: checks 
sepik200: bets $0.12
faithfulness: folds 
Uncalled bet ($0.12) returned to sepik200
sepik200 collected $0.12 from pot
sepik200: doesn't show hand 
*** SUMMARY ***
Total pot $0.12 | Rake $0 
Board [Jh 3c Kc 2s]
Seat 1: FakaN4Kavera (button) folded before Flop (didn't bet)
Seat 2: Ingyeoking (small blind) folded before Flop
Seat 3: faithfulness (big blind) folded on the Turn
Seat 4: sepik200 collected ($0.12)
Seat 5: Kenbunshoku folded before Flop (didn't bet)
Seat 6: cherry006 folded before Flop (didn't bet)



PokerStars Zoom Hand #257880016937:  Hold'em No Limit ($0.02/$0.05) - 2025/09/25 19:38:14 JST [2025/09/25 6:38:14 ET]
Table 'Donati' 6-max Seat #1 is the button
Seat 1: serg430606 ($5.73 in chips) 
Seat 2: huyjokezy ($5 in chips) 
Seat 3: KRSofM ($4.79 in chips) 
Seat 4: coolDadJimbo ($5.41 in chips) 
Seat 5: FakaN4Kavera ($6.76 in chips) 
Seat 6: egoor199 ($5.41 in chips) 
huyjokezy: posts small blind $0.02
KRSofM: posts big blind $0.05
*** HOLE CARDS ***
Dealt to FakaN4Kavera [2d 8h]
coolDadJimbo: folds 
FakaN4Kavera: folds 
egoor199: raises $0.05 to $0.10
serg430606: calls $0.10
huyjokezy: folds 
KRSofM: calls $0.05
*** FLOP *** [Qd 5d 4c]
KRSofM: checks 
egoor199: checks 
serg430606: bets $0.15
KRSofM: raises $0.46 to $0.61
egoor199: folds 
serg430606: folds 
Uncalled bet ($0.46) returned to KRSofM
KRSofM collected $0.59 from pot
KRSofM: doesn't show hand 
*** SUMMARY ***
Total pot $0.62 | Rake $0.03 
Board [Qd 5d 4c]
Seat 1: serg430606 (button) folded on the Flop
Seat 2: huyjokezy (small blind) folded before Flop
Seat 3: KRSofM (big blind) collected ($0.59)
Seat 4: coolDadJimbo folded before Flop (didn't bet)
Seat 5: FakaN4Kavera folded before Flop (didn't bet)
Seat 6: egoor199 folded on the Flop



PokerStars Zoom Hand #257880020715:  Hold'em No Limit ($0.02/$0.05) - 2025/09/25 19:38:53 JST [2025/09/25 6:38:53 ET]
Table 'Donati' 6-max Seat #1 is the button
Seat 1: VXNX$157 ($2.45 in chips) 
Seat 2: 1Kronos ($10.23 in chips) 
Seat 3: Epist461 ($5 in chips) 
Seat 4: IBRODIAN-ACER ($5.07 in chips) 
Seat 5: Kenzo2211 ($5 in chips) 
Seat 6: FakaN4Kavera ($6.76 in chips) 
1Kronos: posts small blind $0.02
Epist461: posts big blind $0.05
*** HOLE CARDS ***
Dealt to FakaN4Kavera [Kh 4h]
IBRODIAN-ACER: folds 
Kenzo2211: folds 
FakaN4Kavera: folds 
VXNX$157: raises $0.07 to $0.12
1Kronos: folds 
Epist461: folds 
Uncalled bet ($0.07) returned to VXNX$157
VXNX$157 collected $0.12 from pot
VXNX$157: doesn't show hand 
*** SUMMARY ***
Total pot $0.12 | Rake $0 
Seat 1: VXNX$157 (button) collected ($0.12)
Seat 2: 1Kronos (small blind) folded before Flop
Seat 3: Epist461 (big blind) folded before Flop
Seat 4: IBRODIAN-ACER folded before Flop (didn't bet)
Seat 5: Kenzo2211 folded before Flop (didn't bet)
Seat 6: FakaN4Kavera folded before Flop (didn't bet)



PokerStars Zoom Hand #257880021326:  Hold'em No Limit ($0.02/$0.05) - 2025/09/25 19:38:59 JST [2025/09/25 6:38:59 ET]
Table 'Donati' 6-max Seat #1 is the button
Seat 1: IBRODIAN-ACER ($5.14 in chips) 
Seat 2: semmely ($9.31 in chips) 
Seat 3: intentii ($5.68 in chips) 
Seat 4: FakaN4Kavera ($6.76 in chips) 
Seat 5: YAG5292 ($5.53 in chips) 
Seat 6: kalopara ($10.14 in chips) 
semmely: posts small blind $0.02
intentii: posts big blind $0.05
*** HOLE CARDS ***
Dealt to FakaN4Kavera [Kd Ks]
FakaN4Kavera: raises $0.07 to $0.12
YAG5292: folds 
kalopara: folds 
IBRODIAN-ACER: folds 
semmely: folds 
intentii: folds 
Uncalled bet ($0.07) returned to FakaN4Kavera
FakaN4Kavera collected $0.12 from pot
FakaN4Kavera: doesn't show hand 
*** SUMMARY ***
Total pot $0.12 | Rake $0 
Seat 1: IBRODIAN-ACER (button) folded before Flop (didn't bet)
Seat 2: semmely (small blind) folded before Flop
Seat 3: intentii (big blind) folded before Flop
Seat 4: FakaN4Kavera collected ($0.12)
Seat 5: YAG5292 folded before Flop (didn't bet)
Seat 6: kalopara folded before Flop (didn't bet)



PokerStars Zoom Hand #257880019898:  Hold'em No Limit ($0.02/$0.05) - 2025/09/25 19:38:45 JST [2025/09/25 6:38:45 ET]
Table 'Donati' 6-max Seat #1 is the button
Seat 1: cherry006 ($4.03 in chips) 
Seat 2: Kenzo2211 ($5.10 in chips) 
Seat 3: zodapoker ($6.29 in chips) 
Seat 4: titeuf3012 ($4.21 in chips) 
Seat 5: FakaN4Kavera ($6.76 in chips) 
Seat 6: Epist461 ($5 in chips) 
Kenzo2211: posts small blind $0.02
zodapoker: posts big blind $0.05
*** HOLE CARDS ***
Dealt to FakaN4Kavera [Kd Jh]
titeuf3012: calls $0.05
FakaN4Kavera: folds 
Epist461: folds 
cherry006: calls $0.05
Kenzo2211: folds 
zodapoker: checks 
*** FLOP *** [Qc Ac 4h]
zodapoker: checks 
titeuf3012: checks 
cherry006: checks 
*** TURN *** [Qc Ac 4h] [8s]
zodapoker: checks 
titeuf3012: checks 
cherry006: checks 
*** RIVER *** [Qc Ac 4h 8s] [Ts]
zodapoker: checks 
titeuf3012: checks 
cherry006: checks 
*** SHOW DOWN ***
zodapoker: shows [2s 8h] (a pair of Eights)
titeuf3012: mucks hand 
cherry006: mucks hand 
zodapoker collected $0.16 from pot
*** SUMMARY ***
Total pot $0.17 | Rake $0.01 
Board [Qc Ac 4h 8s Ts]
Seat 1: cherry006 (button) mucked [3d 3h]
Seat 2: Kenzo2211 (small blind) folded before Flop
Seat 3: zodapoker (big blind) showed [2s 8h] and won ($0.16) with a pair of Eights
Seat 4: titeuf3012 mucked [6s 6h]
Seat 5: FakaN4Kavera folded before Flop (didn't bet)
Seat 6: Epist461 folded before Flop (didn't bet)



PokerStars Zoom Hand #257880023720:  Hold'em No Limit ($0.02/$0.05) - 2025/09/25 19:39:22 JST [2025/09/25 6:39:22 ET]
Table 'Donati' 6-max Seat #1 is the button
Seat 1: FakaN4Kavera ($6.83 in chips) 
Seat 2: kalopara ($4.22 in chips) 
Seat 3: IBRODIAN-ACER ($5.12 in chips) 
Seat 4: scottie4barnes ($3.86 in chips) 
Seat 5: kmc4444 ($5 in chips) 
Seat 6: Schöngeist71 ($12.46 in chips) 
kalopara: posts small blind $0.02
IBRODIAN-ACER: posts big blind $0.05
*** HOLE CARDS ***
Dealt to FakaN4Kavera [3s 4h]
scottie4barnes: folds 
kmc4444: folds 
Schöngeist71: folds 
FakaN4Kavera: folds 
kalopara: folds 
Uncalled bet ($0.03) returned to IBRODIAN-ACER
IBRODIAN-ACER collected $0.04 from pot
IBRODIAN-ACER: doesn't show hand 
*** SUMMARY ***
Total pot $0.04 | Rake $0 
Seat 1: FakaN4Kavera (button) folded before Flop (didn't bet)
Seat 2: kalopara (small blind) folded before Flop
Seat 3: IBRODIAN-ACER (big blind) collected ($0.04)
Seat 4: scottie4barnes folded before Flop (didn't bet)
Seat 5: kmc4444 folded before Flop (didn't bet)
Seat 6: Schöngeist71 folded before Flop (didn't bet)



PokerStars Zoom Hand #257880024026:  Hold'em No Limit ($0.02/$0.05) - 2025/09/25 19:39:26 JST [2025/09/25 6:39:26 ET]
Table 'Donati' 6-max Seat #1 is the button
Seat 1: 1Kronos ($10.16 in chips) 
Seat 2: huyjokezy ($5 in chips) 
Seat 3: FakaN4Kavera ($6.83 in chips) 
Seat 4: egoor199 ($5.24 in chips) 
Seat 5: coolDadJimbo ($5.58 in chips) 
Seat 6: KRSofM ($5 in chips) 
huyjokezy: posts small blind $0.02
FakaN4Kavera: posts big blind $0.05
*** HOLE CARDS ***
Dealt to FakaN4Kavera [6d Qc]
egoor199: raises $0.05 to $0.10
coolDadJimbo: folds 
KRSofM: folds 
1Kronos: folds 
huyjokezy: folds 
FakaN4Kavera: folds 
Uncalled bet ($0.05) returned to egoor199
egoor199 collected $0.12 from pot
egoor199: doesn't show hand 
*** SUMMARY ***
Total pot $0.12 | Rake $0 
Seat 1: 1Kronos (button) folded before Flop (didn't bet)
Seat 2: huyjokezy (small blind) folded before Flop
Seat 3: FakaN4Kavera (big blind) folded before Flop
Seat 4: egoor199 collected ($0.12)
Seat 5: coolDadJimbo folded before Flop (didn't bet)
Seat 6: KRSofM folded before Flop (didn't bet)



PokerStars Zoom Hand #257880025691:  Hold'em No Limit ($0.02/$0.05) - 2025/09/25 19:39:43 JST [2025/09/25 6:39:43 ET]
Table 'Donati' 6-max Seat #1 is the button
Seat 1: faithfulness ($5 in chips) 
Seat 2: FakaN4Kavera ($6.78 in chips) 
Seat 3: kalopara ($6.95 in chips) 
Seat 4: egoor199 ($5.31 in chips) 
Seat 5: DurandalMIA ($3.57 in chips) 
Seat 6: 1Kronos ($5.50 in chips) 
FakaN4Kavera: posts small blind $0.02
kalopara: posts big blind $0.05
*** HOLE CARDS ***
Dealt to FakaN4Kavera [9h 5d]
egoor199: folds 
DurandalMIA: folds 
1Kronos: raises $0.07 to $0.12
faithfulness: folds 
FakaN4Kavera: folds 
kalopara: folds 
Uncalled bet ($0.07) returned to 1Kronos
1Kronos collected $0.12 from pot
1Kronos: doesn't show hand 
*** SUMMARY ***
Total pot $0.12 | Rake $0 
Seat 1: faithfulness (button) folded before Flop (didn't bet)
Seat 2: FakaN4Kavera (small blind) folded before Flop
Seat 3: kalopara (big blind) folded before Flop
Seat 4: egoor199 folded before Flop (didn't bet)
Seat 5: DurandalMIA folded before Flop (didn't bet)
Seat 6: 1Kronos collected ($0.12)



PokerStars Zoom Hand #257880026583:  Hold'em No Limit ($0.02/$0.05) - 2025/09/25 19:39:52 JST [2025/09/25 6:39:52 ET]
Table 'Donati' 6-max Seat #1 is the button
Seat 1: faithfulness ($5.16 in chips) 
Seat 2: Baikasas ($5.04 in chips) 
Seat 3: serg430606 ($5.53 in chips) 
Seat 4: elmex886 ($6.02 in chips) 
Seat 5: FakaN4Kavera ($6.76 in chips) 
Seat 6: dervoigt ($4.39 in chips) 
Baikasas: posts small blind $0.02
serg430606: posts big blind $0.05
*** HOLE CARDS ***
Dealt to FakaN4Kavera [9h Kd]
elmex886: folds 
FakaN4Kavera: folds 
dervoigt: folds 
faithfulness: raises $0.07 to $0.12
Baikasas: folds 
serg430606: folds 
Uncalled bet ($0.07) returned to faithfulness
faithfulness collected $0.12 from pot
faithfulness: doesn't show hand 
*** SUMMARY ***
Total pot $0.12 | Rake $0 
Seat 1: faithfulness (button) collected ($0.12)
Seat 2: Baikasas (small blind) folded before Flop
Seat 3: serg430606 (big blind) folded before Flop
Seat 4: elmex886 folded before Flop (didn't bet)
Seat 5: FakaN4Kavera folded before Flop (didn't bet)
Seat 6: dervoigt folded before Flop (didn't bet)



PokerStars Zoom Hand #257880025098:  Hold'em No Limit ($0.02/$0.05) - 2025/09/25 19:39:37 JST [2025/09/25 6:39:37 ET]
Table 'Donati' 6-max Seat #1 is the button
Seat 1: muhaaa3000 ($4.16 in chips) 
Seat 2: KRSofM ($4.89 in chips) 
Seat 3: YAG5292 ($11.06 in chips) 
Seat 4: FakaN4Kavera ($6.78 in chips) 
Seat 5: 1Kronos ($10.16 in chips) 
Seat 6: kmc4444 ($5.07 in chips) 
KRSofM: posts small blind $0.02
YAG5292: posts big blind $0.05
*** HOLE CARDS ***
Dealt to FakaN4Kavera [9h 3c]
FakaN4Kavera: folds 
1Kronos: folds 
kmc4444: folds 
muhaaa3000: calls $0.05
KRSofM: folds 
YAG5292: checks 
*** FLOP *** [7d Ad Jc]
YAG5292: bets $0.09
muhaaa3000: calls $0.09
*** TURN *** [7d Ad Jc] [2s]
YAG5292: checks 
muhaaa3000: checks 
*** RIVER *** [7d Ad Jc 2s] [2c]
YAG5292: checks 
muhaaa3000: checks 
*** SHOW DOWN ***
YAG5292: shows [Kd 6d] (a pair of Deuces)
muhaaa3000: shows [Qd Ks] (a pair of Deuces - Ace+King+Queen kicker)
muhaaa3000 collected $0.29 from pot
*** SUMMARY ***
Total pot $0.30 | Rake $0.01 
Board [7d Ad Jc 2s 2c]
Seat 1: muhaaa3000 (button) showed [Qd Ks] and won ($0.29) with a pair of Deuces
Seat 2: KRSofM (small blind) folded before Flop
Seat 3: YAG5292 (big blind) showed [Kd 6d] and lost with a pair of Deuces
Seat 4: FakaN4Kavera folded before Flop (didn't bet)
Seat 5: 1Kronos folded before Flop (didn't bet)
Seat 6: kmc4444 folded before Flop (didn't bet)



PokerStars Zoom Hand #257880026102:  Hold'em No Limit ($0.02/$0.05) - 2025/09/25 19:39:47 JST [2025/09/25 6:39:47 ET]
Table 'Donati' 6-max Seat #1 is the button
Seat 1: huyjokezy ($5 in chips) 
Seat 2: faithfulness ($5 in chips) 
Seat 3: intentii ($6.85 in chips) 
Seat 4: FakaN4Kavera ($6.76 in chips) 
Seat 5: KRSofM ($5 in chips) 
Seat 6: egoor199 ($5.31 in chips) 
faithfulness: posts small blind $0.02
intentii: posts big blind $0.05
*** HOLE CARDS ***
Dealt to FakaN4Kavera [8c 3c]
FakaN4Kavera: folds 
KRSofM: raises $0.05 to $0.10
egoor199: folds 
huyjokezy: folds 
faithfulness: folds 
intentii: folds 
Uncalled bet ($0.05) returned to KRSofM
KRSofM collected $0.12 from pot
KRSofM: doesn't show hand 
*** SUMMARY ***
Total pot $0.12 | Rake $0 
Seat 1: huyjokezy (button) folded before Flop (didn't bet)
Seat 2: faithfulness (small blind) folded before Flop
Seat 3: intentii (big blind) folded before Flop
Seat 4: FakaN4Kavera folded before Flop (didn't bet)
Seat 5: KRSofM collected ($0.12)
Seat 6: egoor199 folded before Flop (didn't bet)



PokerStars Zoom Hand #257880027434:  Hold'em No Limit ($0.02/$0.05) - 2025/09/25 19:40:00 JST [2025/09/25 6:40:00 ET]
Table 'Donati' 6-max Seat #1 is the button
Seat 1: Vasco4430 ($9.93 in chips) 
Seat 2: FakaN4Kavera ($6.76 in chips) 
Seat 3: franks270 ($11.85 in chips) 
Seat 4: serg430606 ($5.48 in chips) 
Seat 5: Schöngeist71 ($12.51 in chips) 
Seat 6: coolDadJimbo ($5.63 in chips) 
FakaN4Kavera: posts small blind $0.02
franks270: posts big blind $0.05
*** HOLE CARDS ***
Dealt to FakaN4Kavera [9c Qd]
serg430606: folds 
Schöngeist71: folds 
coolDadJimbo: folds 
Vasco4430: folds 
FakaN4Kavera: folds 
Uncalled bet ($0.03) returned to franks270
franks270 collected $0.04 from pot
franks270: doesn't show hand 
*** SUMMARY ***
Total pot $0.04 | Rake $0 
Seat 1: Vasco4430 (button) folded before Flop (didn't bet)
Seat 2: FakaN4Kavera (small blind) folded before Flop
Seat 3: franks270 (big blind) collected ($0.04)
Seat 4: serg430606 folded before Flop (didn't bet)
Seat 5: Schöngeist71 folded before Flop (didn't bet)
Seat 6: coolDadJimbo folded before Flop (didn't bet)



PokerStars Zoom Hand #257880026976:  Hold'em No Limit ($0.02/$0.05) - 2025/09/25 19:39:56 JST [2025/09/25 6:39:56 ET]
Table 'Donati' 6-max Seat #1 is the button
Seat 1: FakaN4Kavera ($6.76 in chips) 
Seat 2: kmc4444 ($5.02 in chips) 
Seat 3: egoor199 ($5.31 in chips) 
Seat 4: 1Kronos ($5.57 in chips) 
Seat 5: Ingyeoking ($4.95 in chips) 
Seat 6: Schöngeist71 ($12.51 in chips) 
kmc4444: posts small blind $0.02
egoor199: posts big blind $0.05
*** HOLE CARDS ***
Dealt to FakaN4Kavera [6s Kd]
1Kronos: folds 
Ingyeoking: raises $0.05 to $0.10
Schöngeist71: folds 
FakaN4Kavera: folds 
kmc4444: folds 
egoor199: folds 
Uncalled bet ($0.05) returned to Ingyeoking
Ingyeoking collected $0.12 from pot
Ingyeoking: doesn't show hand 
*** SUMMARY ***
Total pot $0.12 | Rake $0 
Seat 1: FakaN4Kavera (button) folded before Flop (didn't bet)
Seat 2: kmc4444 (small blind) folded before Flop
Seat 3: egoor199 (big blind) folded before Flop
Seat 4: 1Kronos folded before Flop (didn't bet)
Seat 5: Ingyeoking collected ($0.12)
Seat 6: Schöngeist71 folded before Flop (didn't bet)



PokerStars Zoom Hand #257880024705:  Hold'em No Limit ($0.02/$0.05) - 2025/09/25 19:39:33 JST [2025/09/25 6:39:33 ET]
Table 'Donati' 6-max Seat #1 is the button
Seat 1: kalopara ($4.20 in chips) 
Seat 2: intentii ($5 in chips) 
Seat 3: hugoreisssss ($6.02 in chips) 
Seat 4: Epist461 ($6.60 in chips) 
Seat 5: YAG5292 ($11.06 in chips) 
Seat 6: FakaN4Kavera ($6.78 in chips) 
intentii: posts small blind $0.02
hugoreisssss: posts big blind $0.05
*** HOLE CARDS ***
Dealt to FakaN4Kavera [3h 7d]
Epist461: raises $0.05 to $0.10
YAG5292: folds 
FakaN4Kavera: folds 
kalopara: calls $0.10
intentii: folds 
hugoreisssss: folds 
*** FLOP *** [Jc 8c 8d]
Epist461: checks 
kalopara: checks 
*** TURN *** [Jc 8c 8d] [Jd]
Epist461: checks 
kalopara: bets $0.10
Epist461: calls $0.10
*** RIVER *** [Jc 8c 8d Jd] [As]
Epist461: checks 
kalopara: bets $0.25
Epist461: raises $0.25 to $0.50
kalopara: calls $0.25
*** SHOW DOWN ***
Epist461: shows [Ad Ks] (two pair, Aces and Jacks)
kalopara: shows [Js Kh] (a full house, Jacks full of Eights)
kalopara collected $1.41 from pot
*** SUMMARY ***
Total pot $1.47 | Rake $0.06 
Board [Jc 8c 8d Jd As]
Seat 1: kalopara (button) showed [Js Kh] and won ($1.41) with a full house, Jacks full of Eights
Seat 2: intentii (small blind) folded before Flop
Seat 3: hugoreisssss (big blind) folded before Flop
Seat 4: Epist461 showed [Ad Ks] and lost with two pair, Aces and Jacks
Seat 5: YAG5292 folded before Flop (didn't bet)
Seat 6: FakaN4Kavera folded before Flop (didn't bet)



PokerStars Zoom Hand #257880029015:  Hold'em No Limit ($0.02/$0.05) - 2025/09/25 19:40:15 JST [2025/09/25 6:40:15 ET]
Table 'Donati' 6-max Seat #1 is the button
Seat 1: zodapoker ($6.65 in chips) 
Seat 2: huyjokezy ($5.78 in chips) 
Seat 3: FakaN4Kavera ($6.74 in chips) 
Seat 4: leakleakA ($12.97 in chips) 
Seat 5: Coco_bear373 ($13.59 in chips) 
Seat 6: IBRODIAN-ACER ($5.14 in chips) 
huyjokezy: posts small blind $0.02
FakaN4Kavera: posts big blind $0.05
*** HOLE CARDS ***
Dealt to FakaN4Kavera [8c Kd]
leakleakA: folds 
Coco_bear373: folds 
IBRODIAN-ACER: folds 
zodapoker: folds 
huyjokezy: raises $0.10 to $0.15
FakaN4Kavera: folds 
Uncalled bet ($0.10) returned to huyjokezy
huyjokezy collected $0.10 from pot
huyjokezy: doesn't show hand 
*** SUMMARY ***
Total pot $0.10 | Rake $0 
Seat 1: zodapoker (button) folded before Flop (didn't bet)
Seat 2: huyjokezy (small blind) collected ($0.10)
Seat 3: FakaN4Kavera (big blind) folded before Flop
Seat 4: leakleakA folded before Flop (didn't bet)
Seat 5: Coco_bear373 folded before Flop (didn't bet)
Seat 6: IBRODIAN-ACER folded before Flop (didn't bet)



PokerStars Zoom Hand #257880027854:  Hold'em No Limit ($0.02/$0.05) - 2025/09/25 19:40:04 JST [2025/09/25 6:40:04 ET]
Table 'Donati' 6-max Seat #1 is the button
Seat 1: skygger777 ($5.30 in chips) 
Seat 2: serg430606 ($5.48 in chips) 
Seat 3: Schöngeist71 ($12.51 in chips) 
Seat 4: titeuf3012 ($4.09 in chips) 
Seat 5: FakaN4Kavera ($6.74 in chips) 
Seat 6: sepik200 ($4.60 in chips) 
serg430606: posts small blind $0.02
Schöngeist71: posts big blind $0.05
*** HOLE CARDS ***
Dealt to FakaN4Kavera [9d Kc]
titeuf3012: folds 
FakaN4Kavera: folds 
sepik200: folds 
skygger777: raises $0.10 to $0.15
serg430606: folds 
Schöngeist71: calls $0.10
*** FLOP *** [Ks 3h Ad]
Schöngeist71: checks 
skygger777: checks 
*** TURN *** [Ks 3h Ad] [9s]
Schöngeist71: bets $0.10
skygger777: raises $0.40 to $0.50
Schöngeist71: folds 
Uncalled bet ($0.40) returned to skygger777
skygger777 collected $0.50 from pot
skygger777: doesn't show hand 
*** SUMMARY ***
Total pot $0.52 | Rake $0.02 
Board [Ks 3h Ad 9s]
Seat 1: skygger777 (button) collected ($0.50)
Seat 2: serg430606 (small blind) folded before Flop
Seat 3: Schöngeist71 (big blind) folded on the Turn
Seat 4: titeuf3012 folded before Flop (didn't bet)
Seat 5: FakaN4Kavera folded before Flop (didn't bet)
Seat 6: sepik200 folded before Flop (didn't bet)



PokerStars Zoom Hand #257880031442:  Hold'em No Limit ($0.02/$0.05) - 2025/09/25 19:40:39 JST [2025/09/25 6:40:39 ET]
Table 'Donati' 6-max Seat #1 is the button
Seat 1: IBRODIAN-ACER ($5.07 in chips) 
Seat 2: 1Kronos ($10.23 in chips) 
Seat 3: faithfulness ($5.26 in chips) 
Seat 4: FakaN4Kavera ($6.69 in chips) 
Seat 5: zodapoker ($7.51 in chips) 
Seat 6: cherry006 ($3.88 in chips) 
1Kronos: posts small blind $0.02
faithfulness: posts big blind $0.05
*** HOLE CARDS ***
Dealt to FakaN4Kavera [3h 4h]
FakaN4Kavera: folds 
zodapoker: raises $0.07 to $0.12
cherry006: folds 
IBRODIAN-ACER: folds 
1Kronos: raises $0.43 to $0.55
faithfulness: folds 
zodapoker: folds 
Uncalled bet ($0.43) returned to 1Kronos
1Kronos collected $0.29 from pot
1Kronos: doesn't show hand 
*** SUMMARY ***
Total pot $0.29 | Rake $0 
Seat 1: IBRODIAN-ACER (button) folded before Flop (didn't bet)
Seat 2: 1Kronos (small blind) collected ($0.29)
Seat 3: faithfulness (big blind) folded before Flop
Seat 4: FakaN4Kavera folded before Flop (didn't bet)
Seat 5: zodapoker folded before Flop
Seat 6: cherry006 folded before Flop (didn't bet)



PokerStars Zoom Hand #257880033216:  Hold'em No Limit ($0.02/$0.05) - 2025/09/25 19:40:56 JST [2025/09/25 6:40:56 ET]
Table 'Donati' 6-max Seat #1 is the button
Seat 1: FakaN4Kavera ($6.69 in chips) 
Seat 2: intentii ($5 in chips) 
Seat 3: kalopara ($4.79 in chips) 
Seat 4: IBRODIAN-ACER ($5.07 in chips) 
Seat 5: cherry006 ($3.86 in chips) 
Seat 6: egoor199 ($5.62 in chips) 
intentii: posts small blind $0.02
kalopara: posts big blind $0.05
*** HOLE CARDS ***
Dealt to FakaN4Kavera [Th 2c]
IBRODIAN-ACER: folds 
cherry006: folds 
egoor199: folds 
FakaN4Kavera: folds 
intentii: folds 
Uncalled bet ($0.03) returned to kalopara
kalopara collected $0.04 from pot
kalopara: doesn't show hand 
*** SUMMARY ***
Total pot $0.04 | Rake $0 
Seat 1: FakaN4Kavera (button) folded before Flop (didn't bet)
Seat 2: intentii (small blind) folded before Flop
Seat 3: kalopara (big blind) collected ($0.04)
Seat 4: IBRODIAN-ACER folded before Flop (didn't bet)
Seat 5: cherry006 folded before Flop (didn't bet)
Seat 6: egoor199 folded before Flop (didn't bet)



PokerStars Zoom Hand #257880033831:  Hold'em No Limit ($0.02/$0.05) - 2025/09/25 19:41:02 JST [2025/09/25 6:41:02 ET]
Table 'Donati' 6-max Seat #1 is the button
Seat 1: egoor199 ($5.62 in chips) 
Seat 2: faithfulness ($5.21 in chips) 
Seat 3: FakaN4Kavera ($6.69 in chips) 
Seat 4: IBRODIAN-ACER ($5 in chips) 
Seat 5: tomis1312 ($5 in chips) 
Seat 6: 1Kronos ($12.73 in chips) 
faithfulness: posts small blind $0.02
FakaN4Kavera: posts big blind $0.05
*** HOLE CARDS ***
Dealt to FakaN4Kavera [7h As]
IBRODIAN-ACER: folds 
tomis1312: folds 
1Kronos: folds 
egoor199: folds 
faithfulness: raises $0.10 to $0.15
FakaN4Kavera: folds 
Uncalled bet ($0.10) returned to faithfulness
faithfulness collected $0.10 from pot
faithfulness: doesn't show hand 
*** SUMMARY ***
Total pot $0.10 | Rake $0 
Seat 1: egoor199 (button) folded before Flop (didn't bet)
Seat 2: faithfulness (small blind) collected ($0.10)
Seat 3: FakaN4Kavera (big blind) folded before Flop
Seat 4: IBRODIAN-ACER folded before Flop (didn't bet)
Seat 5: tomis1312 folded before Flop (didn't bet)
Seat 6: 1Kronos folded before Flop (didn't bet)



PokerStars Zoom Hand #257880028560:  Hold'em No Limit ($0.02/$0.05) - 2025/09/25 19:40:11 JST [2025/09/25 6:40:11 ET]
Table 'Donati' 6-max Seat #1 is the button
Seat 1: franks270 ($11.87 in chips) 
Seat 2: IBRODIAN-ACER ($5.16 in chips) 
Seat 3: Brun077a ($5 in chips) 
Seat 4: faithfulness ($5 in chips) 
Seat 5: KRSofM ($6.02 in chips) 
Seat 6: FakaN4Kavera ($6.74 in chips) 
IBRODIAN-ACER: posts small blind $0.02
Brun077a: posts big blind $0.05
*** HOLE CARDS ***
Dealt to FakaN4Kavera [8d Jc]
faithfulness: folds 
KRSofM: folds 
FakaN4Kavera: folds 
franks270: calls $0.05
IBRODIAN-ACER: folds 
Brun077a: checks 
*** FLOP *** [Jd Kh 7s]
Brun077a: checks 
franks270: bets $0.05
Brun077a: folds 
Uncalled bet ($0.05) returned to franks270
franks270 collected $0.12 from pot
franks270: doesn't show hand 
*** SUMMARY ***
Total pot $0.12 | Rake $0 
Board [Jd Kh 7s]
Seat 1: franks270 (button) collected ($0.12)
Seat 2: IBRODIAN-ACER (small blind) folded before Flop
Seat 3: Brun077a (big blind) folded on the Flop
Seat 4: faithfulness folded before Flop (didn't bet)
Seat 5: KRSofM folded before Flop (didn't bet)
Seat 6: FakaN4Kavera folded before Flop (didn't bet)



PokerStars Zoom Hand #257880035588:  Hold'em No Limit ($0.02/$0.05) - 2025/09/25 19:41:19 JST [2025/09/25 6:41:19 ET]
Table 'Donati' 6-max Seat #1 is the button
Seat 1: Ingyeoking ($4.93 in chips) 
Seat 2: goaßmaß-fips ($14.23 in chips) 
Seat 3: TTPP92 ($5.77 in chips) 
Seat 4: YAG5292 ($2.21 in chips) 
Seat 5: KRSofM ($4.95 in chips) 
Seat 6: FakaN4Kavera ($6.62 in chips) 
goaßmaß-fips: posts small blind $0.02
TTPP92: posts big blind $0.05
*** HOLE CARDS ***
Dealt to FakaN4Kavera [Ts Kc]
YAG5292: folds 
KRSofM: folds 
FakaN4Kavera: raises $0.07 to $0.12
Ingyeoking: folds 
goaßmaß-fips: folds 
TTPP92: folds 
Uncalled bet ($0.07) returned to FakaN4Kavera
FakaN4Kavera collected $0.12 from pot
FakaN4Kavera: doesn't show hand 
*** SUMMARY ***
Total pot $0.12 | Rake $0 
Seat 1: Ingyeoking (button) folded before Flop (didn't bet)
Seat 2: goaßmaß-fips (small blind) folded before Flop
Seat 3: TTPP92 (big blind) folded before Flop
Seat 4: YAG5292 folded before Flop (didn't bet)
Seat 5: KRSofM folded before Flop (didn't bet)
Seat 6: FakaN4Kavera collected ($0.12)



PokerStars Zoom Hand #257880031736:  Hold'em No Limit ($0.02/$0.05) - 2025/09/25 19:40:42 JST [2025/09/25 6:40:42 ET]
Table 'Donati' 6-max Seat #1 is the button
Seat 1: huyjokezy ($5.83 in chips) 
Seat 2: Schöngeist71 ($12.26 in chips) 
Seat 3: IBRODIAN-ACER ($5 in chips) 
Seat 4: egoor199 ($6.51 in chips) 
Seat 5: FakaN4Kavera ($6.69 in chips) 
Seat 6: kalopara ($6.63 in chips) 
Schöngeist71: posts small blind $0.02
IBRODIAN-ACER: posts big blind $0.05
*** HOLE CARDS ***
Dealt to FakaN4Kavera [6h 3s]
egoor199: raises $0.05 to $0.10
FakaN4Kavera: folds 
kalopara: calls $0.10
huyjokezy: folds 
Schöngeist71: folds 
IBRODIAN-ACER: folds 
*** FLOP *** [5c 4c Ac]
egoor199: checks 
kalopara: checks 
*** TURN *** [5c 4c Ac] [Ad]
egoor199: checks 
kalopara: checks 
*** RIVER *** [5c 4c Ac Ad] [2c]
egoor199: checks 
kalopara: bets $0.10
egoor199: folds 
Uncalled bet ($0.10) returned to kalopara
kalopara collected $0.26 from pot
kalopara: doesn't show hand 
*** SUMMARY ***
Total pot $0.27 | Rake $0.01 
Board [5c 4c Ac Ad 2c]
Seat 1: huyjokezy (button) folded before Flop (didn't bet)
Seat 2: Schöngeist71 (small blind) folded before Flop
Seat 3: IBRODIAN-ACER (big blind) folded before Flop
Seat 4: egoor199 folded on the River
Seat 5: FakaN4Kavera folded before Flop (didn't bet)
Seat 6: kalopara collected ($0.26)



PokerStars Zoom Hand #257880034960:  Hold'em No Limit ($0.02/$0.05) - 2025/09/25 19:41:13 JST [2025/09/25 6:41:13 ET]
Table 'Donati' 6-max Seat #1 is the button
Seat 1: Miss Turbo G ($5.65 in chips) 
Seat 2: FakaN4Kavera ($6.64 in chips) 
Seat 3: egoor199 ($5.62 in chips) 
Seat 4: IBRODIAN-ACER ($5.02 in chips) 
Seat 5: Schöngeist71 ($12.43 in chips) 
Seat 6: YAG5292 ($2.21 in chips) 
FakaN4Kavera: posts small blind $0.02
egoor199: posts big blind $0.05
*** HOLE CARDS ***
Dealt to FakaN4Kavera [3s Kh]
IBRODIAN-ACER: raises $0.05 to $0.10
Schöngeist71: calls $0.10
YAG5292: folds 
Miss Turbo G: raises $0.37 to $0.47
FakaN4Kavera: folds 
egoor199: folds 
IBRODIAN-ACER: folds 
Schöngeist71: calls $0.37
*** FLOP *** [9h 4d 7c]
Schöngeist71: checks 
Miss Turbo G: bets $1.11
Schöngeist71: folds 
Uncalled bet ($1.11) returned to Miss Turbo G
Miss Turbo G collected $1.06 from pot
Miss Turbo G: doesn't show hand 
*** SUMMARY ***
Total pot $1.11 | Rake $0.05 
Board [9h 4d 7c]
Seat 1: Miss Turbo G (button) collected ($1.06)
Seat 2: FakaN4Kavera (small blind) folded before Flop
Seat 3: egoor199 (big blind) folded before Flop
Seat 4: IBRODIAN-ACER folded before Flop
Seat 5: Schöngeist71 folded on the Flop
Seat 6: YAG5292 folded before Flop (didn't bet)



PokerStars Zoom Hand #257880037374:  Hold'em No Limit ($0.02/$0.05) - 2025/09/25 19:41:36 JST [2025/09/25 6:41:36 ET]
Table 'Donati' 6-max Seat #1 is the button
Seat 1: FakaN4Kavera ($6.69 in chips) 
Seat 2: zodapoker ($8.09 in chips) 
Seat 3: 1Kronos ($15.48 in chips) 
Seat 4: faithfulness ($5.42 in chips) 
Seat 5: Megam181 ($4.65 in chips) 
Seat 6: YAG5292 ($10.97 in chips) 
zodapoker: posts small blind $0.02
1Kronos: posts big blind $0.05
*** HOLE CARDS ***
Dealt to FakaN4Kavera [Jc 6d]
faithfulness: folds 
Megam181: calls $0.05
YAG5292: folds 
FakaN4Kavera: folds 
zodapoker: folds 
1Kronos: checks 
*** FLOP *** [3h 4s 8s]
1Kronos: checks 
Megam181: checks 
*** TURN *** [3h 4s 8s] [Js]
1Kronos: checks 
Megam181: bets $0.12
1Kronos: folds 
Uncalled bet ($0.12) returned to Megam181
Megam181 collected $0.12 from pot
Megam181: doesn't show hand 
*** SUMMARY ***
Total pot $0.12 | Rake $0 
Board [3h 4s 8s Js]
Seat 1: FakaN4Kavera (button) folded before Flop (didn't bet)
Seat 2: zodapoker (small blind) folded before Flop
Seat 3: 1Kronos (big blind) folded on the Turn
Seat 4: faithfulness folded before Flop (didn't bet)
Seat 5: Megam181 collected ($0.12)
Seat 6: YAG5292 folded before Flop (didn't bet)



PokerStars Zoom Hand #257880039603:  Hold'em No Limit ($0.02/$0.05) - 2025/09/25 19:41:57 JST [2025/09/25 6:41:57 ET]
Table 'Donati' 6-max Seat #1 is the button
Seat 1: huyjokezy ($5.33 in chips) 
Seat 2: Kenzo2211 ($5 in chips) 
Seat 3: IBRODIAN-ACER ($5.30 in chips) 
Seat 4: goaßmaß-fips ($14.23 in chips) 
Seat 5: cherry006 ($4.06 in chips) 
Seat 6: FakaN4Kavera ($6.62 in chips) 
Kenzo2211: posts small blind $0.02
IBRODIAN-ACER: posts big blind $0.05
*** HOLE CARDS ***
Dealt to FakaN4Kavera [Tc 5d]
goaßmaß-fips: folds 
cherry006: folds 
FakaN4Kavera: folds 
huyjokezy: folds 
Kenzo2211: raises $0.10 to $0.15
IBRODIAN-ACER: folds 
Uncalled bet ($0.10) returned to Kenzo2211
Kenzo2211 collected $0.10 from pot
Kenzo2211: doesn't show hand 
*** SUMMARY ***
Total pot $0.10 | Rake $0 
Seat 1: huyjokezy (button) folded before Flop (didn't bet)
Seat 2: Kenzo2211 (small blind) collected ($0.10)
Seat 3: IBRODIAN-ACER (big blind) folded before Flop
Seat 4: goaßmaß-fips folded before Flop (didn't bet)
Seat 5: cherry006 folded before Flop (didn't bet)
Seat 6: FakaN4Kavera folded before Flop (didn't bet)



PokerStars Zoom Hand #257880037936:  Hold'em No Limit ($0.02/$0.05) - 2025/09/25 19:41:41 JST [2025/09/25 6:41:41 ET]
Table 'Donati' 6-max Seat #1 is the button
Seat 1: huyjokezy ($5 in chips) 
Seat 2: Brun077a ($4.80 in chips) 
Seat 3: faithfulness ($5.33 in chips) 
Seat 4: FakaN4Kavera ($6.69 in chips) 
Seat 5: scottie4barnes ($3.65 in chips) 
Seat 6: KRSofM ($4.90 in chips) 
Brun077a: posts small blind $0.02
faithfulness: posts big blind $0.05
*** HOLE CARDS ***
Dealt to FakaN4Kavera [Tc 3h]
FakaN4Kavera: folds 
scottie4barnes: raises $0.10 to $0.15
KRSofM: folds 
huyjokezy: folds 
Brun077a: calls $0.13
faithfulness: folds 
*** FLOP *** [3s 3c 7s]
Brun077a: checks 
scottie4barnes: checks 
*** TURN *** [3s 3c 7s] [3d]
Brun077a: checks 
scottie4barnes: checks 
*** RIVER *** [3s 3c 7s 3d] [5d]
Brun077a: checks 
scottie4barnes: checks 
*** SHOW DOWN ***
Brun077a: shows [Th Ks] (three of a kind, Threes)
scottie4barnes: mucks hand 
Brun077a collected $0.34 from pot
*** SUMMARY ***
Total pot $0.35 | Rake $0.01 
Board [3s 3c 7s 3d 5d]
Seat 1: huyjokezy (button) folded before Flop (didn't bet)
Seat 2: Brun077a (small blind) showed [Th Ks] and won ($0.34) with three of a kind, Threes
Seat 3: faithfulness (big blind) folded before Flop
Seat 4: FakaN4Kavera folded before Flop (didn't bet)
Seat 5: scottie4barnes mucked [8c Qc]
Seat 6: KRSofM folded before Flop (didn't bet)



PokerStars Zoom Hand #257880038849:  Hold'em No Limit ($0.02/$0.05) - 2025/09/25 19:41:50 JST [2025/09/25 6:41:50 ET]
Table 'Donati' 6-max Seat #1 is the button
Seat 1: Ingyeoking ($10.42 in chips) 
Seat 2: Vasco4430 ($9.85 in chips) 
Seat 3: FakaN4Kavera ($6.67 in chips) 
Seat 4: semmely ($9.35 in chips) 
Seat 5: goaßmaß-fips ($14.23 in chips) 
Seat 6: cherry006 ($4.06 in chips) 
Vasco4430: posts small blind $0.02
FakaN4Kavera: posts big blind $0.05
*** HOLE CARDS ***
Dealt to FakaN4Kavera [Td 6h]
semmely: folds 
goaßmaß-fips: folds 
cherry006: folds 
Ingyeoking: raises $0.07 to $0.12
Vasco4430: calls $0.10
FakaN4Kavera: folds 
*** FLOP *** [3h 8c As]
Vasco4430: checks 
Ingyeoking: checks 
*** TURN *** [3h 8c As] [Qc]
Vasco4430: checks 
Ingyeoking: checks 
*** RIVER *** [3h 8c As Qc] [Qs]
Vasco4430: bets $0.14
Ingyeoking: raises $0.56 to $0.70
Vasco4430: folds 
Uncalled bet ($0.56) returned to Ingyeoking
Ingyeoking collected $0.55 from pot
Ingyeoking: doesn't show hand 
*** SUMMARY ***
Total pot $0.57 | Rake $0.02 
Board [3h 8c As Qc Qs]
Seat 1: Ingyeoking (button) collected ($0.55)
Seat 2: Vasco4430 (small blind) folded on the River
Seat 3: FakaN4Kavera (big blind) folded before Flop
Seat 4: semmely folded before Flop (didn't bet)
Seat 5: goaßmaß-fips folded before Flop (didn't bet)
Seat 6: cherry006 folded before Flop (didn't bet)



PokerStars Zoom Hand #257880038330:  Hold'em No Limit ($0.02/$0.05) - 2025/09/25 19:41:45 JST [2025/09/25 6:41:45 ET]
Table 'Donati' 6-max Seat #1 is the button
Seat 1: elmex886 ($5.88 in chips) 
Seat 2: FakaN4Kavera ($6.69 in chips) 
Seat 3: tomis1312 ($5.17 in chips) 
Seat 4: kalopara ($6.79 in chips) 
Seat 5: ICallForYou ($3.93 in chips) 
Seat 6: zodapoker ($8.07 in chips) 
FakaN4Kavera: posts small blind $0.02
tomis1312: posts big blind $0.05
*** HOLE CARDS ***
Dealt to FakaN4Kavera [2h 7h]
kalopara: folds 
ICallForYou: folds 
zodapoker: raises $0.07 to $0.12
elmex886: folds 
FakaN4Kavera: folds 
tomis1312: calls $0.07
*** FLOP *** [Qd 4d Ah]
tomis1312: checks 
zodapoker: checks 
*** TURN *** [Qd 4d Ah] [3c]
tomis1312: checks 
zodapoker: bets $0.08
tomis1312: calls $0.08
*** RIVER *** [Qd 4d Ah 3c] [7s]
tomis1312: checks 
zodapoker: bets $0.12
tomis1312: calls $0.12
*** SHOW DOWN ***
zodapoker: shows [Ks Kh] (a pair of Kings)
tomis1312: mucks hand 
zodapoker collected $0.63 from pot
*** SUMMARY ***
Total pot $0.66 | Rake $0.03 
Board [Qd 4d Ah 3c 7s]
Seat 1: elmex886 (button) folded before Flop (didn't bet)
Seat 2: FakaN4Kavera (small blind) folded before Flop
Seat 3: tomis1312 (big blind) mucked [Qc 5c]
Seat 4: kalopara folded before Flop (didn't bet)
Seat 5: ICallForYou folded before Flop (didn't bet)
Seat 6: zodapoker showed [Ks Kh] and won ($0.63) with a pair of Kings



PokerStars Zoom Hand #257880040508:  Hold'em No Limit ($0.02/$0.05) - 2025/09/25 19:42:06 JST [2025/09/25 6:42:06 ET]
Table 'Donati' 6-max Seat #1 is the button
Seat 1: faithfulness ($5 in chips) 
Seat 2: huyjokezy ($6.01 in chips) 
Seat 3: ICallForYou ($4.46 in chips) 
Seat 4: klevinjer ($4.88 in chips) 
Seat 5: FakaN4Kavera ($6.62 in chips) 
Seat 6: franks270 ($12.01 in chips) 
huyjokezy: posts small blind $0.02
ICallForYou: posts big blind $0.05
*** HOLE CARDS ***
Dealt to FakaN4Kavera [6s 9s]
klevinjer: folds 
FakaN4Kavera: folds 
franks270: calls $0.05
faithfulness: folds 
huyjokezy: raises $0.20 to $0.25
ICallForYou: folds 
franks270: raises $0.50 to $0.75
huyjokezy: folds 
Uncalled bet ($0.50) returned to franks270
franks270 collected $0.55 from pot
franks270: doesn't show hand 
*** SUMMARY ***
Total pot $0.55 | Rake $0 
Seat 1: faithfulness (button) folded before Flop (didn't bet)
Seat 2: huyjokezy (small blind) folded before Flop
Seat 3: ICallForYou (big blind) folded before Flop
Seat 4: klevinjer folded before Flop (didn't bet)
Seat 5: FakaN4Kavera folded before Flop (didn't bet)
Seat 6: franks270 collected ($0.55)



PokerStars Zoom Hand #257880040936:  Hold'em No Limit ($0.02/$0.05) - 2025/09/25 19:42:10 JST [2025/09/25 6:42:10 ET]
Table 'Donati' 6-max Seat #1 is the button
Seat 1: FakaN4Kavera ($6.62 in chips) 
Seat 2: 1Kronos ($15.43 in chips) 
Seat 3: klevinjer ($4.88 in chips) 
Seat 4: egoor199 ($5.71 in chips) 
Seat 5: Ingyeoking ($6.30 in chips) 
Seat 6: kalopara ($4.24 in chips) 
1Kronos: posts small blind $0.02
klevinjer: posts big blind $0.05
*** HOLE CARDS ***
Dealt to FakaN4Kavera [Td Ac]
egoor199: folds 
Ingyeoking: folds 
kalopara: folds 
FakaN4Kavera: raises $0.07 to $0.12
1Kronos: folds 
klevinjer: calls $0.07
*** FLOP *** [Js 8s 8d]
klevinjer: checks 
FakaN4Kavera: checks 
*** TURN *** [Js 8s 8d] [Kc]
klevinjer: checks 
FakaN4Kavera: checks 
*** RIVER *** [Js 8s 8d Kc] [Jd]
klevinjer: bets $0.13
FakaN4Kavera: calls $0.13
*** SHOW DOWN ***
klevinjer: shows [Ks 9d] (two pair, Kings and Jacks)
FakaN4Kavera: mucks hand 
klevinjer collected $0.50 from pot
*** SUMMARY ***
Total pot $0.52 | Rake $0.02 
Board [Js 8s 8d Kc Jd]
Seat 1: FakaN4Kavera (button) mucked [Td Ac]
Seat 2: 1Kronos (small blind) folded before Flop
Seat 3: klevinjer (big blind) showed [Ks 9d] and won ($0.50) with two pair, Kings and Jacks
Seat 4: egoor199 folded before Flop (didn't bet)
Seat 5: Ingyeoking folded before Flop (didn't bet)
Seat 6: kalopara folded before Flop (didn't bet)



PokerStars Zoom Hand #257880044478:  Hold'em No Limit ($0.02/$0.05) - 2025/09/25 19:42:44 JST [2025/09/25 6:42:44 ET]
Table 'Donati' 6-max Seat #1 is the button
Seat 1: kalopara ($6.79 in chips) 
Seat 2: huyjokezy ($5.28 in chips) 
Seat 3: ICallForYou ($4.39 in chips) 
Seat 4: FakaN4Kavera ($6.37 in chips) 
Seat 5: klevinjer ($5.13 in chips) 
Seat 6: KRSofM ($4.93 in chips) 
huyjokezy: posts small blind $0.02
ICallForYou: posts big blind $0.05
*** HOLE CARDS ***
Dealt to FakaN4Kavera [5h 4c]
FakaN4Kavera: folds 
klevinjer: raises $0.07 to $0.12
KRSofM: folds 
kalopara: raises $0.28 to $0.40
huyjokezy: folds 
ICallForYou: folds 
klevinjer: calls $0.28
*** FLOP *** [Jh 6d Js]
klevinjer: checks 
kalopara: checks 
*** TURN *** [Jh 6d Js] [2c]
klevinjer: bets $0.42
kalopara: folds 
Uncalled bet ($0.42) returned to klevinjer
klevinjer collected $0.83 from pot
klevinjer: doesn't show hand 
*** SUMMARY ***
Total pot $0.87 | Rake $0.04 
Board [Jh 6d Js 2c]
Seat 1: kalopara (button) folded on the Turn
Seat 2: huyjokezy (small blind) folded before Flop
Seat 3: ICallForYou (big blind) folded before Flop
Seat 4: FakaN4Kavera folded before Flop (didn't bet)
Seat 5: klevinjer collected ($0.83)
Seat 6: KRSofM folded before Flop (didn't bet)



PokerStars Zoom Hand #257880046410:  Hold'em No Limit ($0.02/$0.05) - 2025/09/25 19:43:03 JST [2025/09/25 6:43:03 ET]
Table 'Donati' 6-max Seat #1 is the button
Seat 1: IBRODIAN-ACER ($5.22 in chips) 
Seat 2: vlad.mdv ($4.95 in chips) 
Seat 3: tomis1312 ($5 in chips) 
Seat 4: huyjokezy ($5.26 in chips) 
Seat 5: FakaN4Kavera ($6.35 in chips) 
Seat 6: KRSofM ($4.83 in chips) 
vlad.mdv: posts small blind $0.02
tomis1312: posts big blind $0.05
*** HOLE CARDS ***
Dealt to FakaN4Kavera [9s 4d]
huyjokezy: raises $0.10 to $0.15
FakaN4Kavera: folds 
KRSofM: folds 
IBRODIAN-ACER: calls $0.15
vlad.mdv: folds 
tomis1312: raises $0.60 to $0.75
huyjokezy: folds 
IBRODIAN-ACER: folds 
Uncalled bet ($0.60) returned to tomis1312
tomis1312 collected $0.47 from pot
tomis1312: doesn't show hand 
*** SUMMARY ***
Total pot $0.47 | Rake $0 
Seat 1: IBRODIAN-ACER (button) folded before Flop
Seat 2: vlad.mdv (small blind) folded before Flop
Seat 3: tomis1312 (big blind) collected ($0.47)
Seat 4: huyjokezy folded before Flop
Seat 5: FakaN4Kavera folded before Flop (didn't bet)
Seat 6: KRSofM folded before Flop (didn't bet)



PokerStars Zoom Hand #257880044900:  Hold'em No Limit ($0.02/$0.05) - 2025/09/25 19:42:48 JST [2025/09/25 6:42:48 ET]
Table 'Donati' 6-max Seat #1 is the button
Seat 1: KRSofM ($4.83 in chips) 
Seat 2: FakaN4Kavera ($6.37 in chips) 
Seat 3: Kenzo2211 ($5.03 in chips) 
Seat 4: lefra9 ($5 in chips) 
Seat 5: huyjokezy ($5.76 in chips) 
Seat 6: kalopara ($4.24 in chips) 
FakaN4Kavera: posts small blind $0.02
Kenzo2211: posts big blind $0.05
*** HOLE CARDS ***
Dealt to FakaN4Kavera [2h 8d]
lefra9: raises $0.15 to $0.20
huyjokezy: folds 
kalopara: folds 
KRSofM: folds 
FakaN4Kavera: folds 
Kenzo2211: calls $0.15
*** FLOP *** [2d Js 4h]
Kenzo2211: checks 
lefra9: bets $0.20
Kenzo2211: folds 
Uncalled bet ($0.20) returned to lefra9
lefra9 collected $0.40 from pot
lefra9: doesn't show hand 
*** SUMMARY ***
Total pot $0.42 | Rake $0.02 
Board [2d Js 4h]
Seat 1: KRSofM (button) folded before Flop (didn't bet)
Seat 2: FakaN4Kavera (small blind) folded before Flop
Seat 3: Kenzo2211 (big blind) folded on the Flop
Seat 4: lefra9 collected ($0.40)
Seat 5: huyjokezy folded before Flop (didn't bet)
Seat 6: kalopara folded before Flop (didn't bet)



PokerStars Zoom Hand #257880048035:  Hold'em No Limit ($0.02/$0.05) - 2025/09/25 19:43:19 JST [2025/09/25 6:43:19 ET]
Table 'Donati' 6-max Seat #1 is the button
Seat 1: huyjokezy ($5.11 in chips) 
Seat 2: Ingyeoking ($6.18 in chips) 
Seat 3: FakaN4Kavera ($6.35 in chips) 
Seat 4: KRSofM ($4.69 in chips) 
Seat 5: Epist461 ($5.14 in chips) 
Seat 6: vlad.mdv ($4.93 in chips) 
Ingyeoking: posts small blind $0.02
FakaN4Kavera: posts big blind $0.05
*** HOLE CARDS ***
Dealt to FakaN4Kavera [4d Kd]
KRSofM: folds 
Epist461: folds 
vlad.mdv: folds 
huyjokezy: folds 
Ingyeoking: folds 
Uncalled bet ($0.03) returned to FakaN4Kavera
FakaN4Kavera collected $0.04 from pot
FakaN4Kavera: doesn't show hand 
*** SUMMARY ***
Total pot $0.04 | Rake $0 
Seat 1: huyjokezy (button) folded before Flop (didn't bet)
Seat 2: Ingyeoking (small blind) folded before Flop
Seat 3: FakaN4Kavera (big blind) collected ($0.04)
Seat 4: KRSofM folded before Flop (didn't bet)
Seat 5: Epist461 folded before Flop (didn't bet)
Seat 6: vlad.mdv folded before Flop (didn't bet)



PokerStars Zoom Hand #257880047020:  Hold'em No Limit ($0.02/$0.05) - 2025/09/25 19:43:09 JST [2025/09/25 6:43:09 ET]
Table 'Donati' 6-max Seat #1 is the button
Seat 1: cherry006 ($3.99 in chips) 
Seat 2: ICallForYou ($4.34 in chips) 
Seat 3: zodapoker ($6.71 in chips) 
Seat 4: FakaN4Kavera ($6.35 in chips) 
Seat 5: YAG5292 ($8.61 in chips) 
Seat 6: intentii ($5 in chips) 
ICallForYou: posts small blind $0.02
zodapoker: posts big blind $0.05
*** HOLE CARDS ***
Dealt to FakaN4Kavera [6c Th]
FakaN4Kavera: folds 
YAG5292: folds 
intentii: folds 
cherry006: folds 
ICallForYou: calls $0.03
zodapoker: checks 
*** FLOP *** [3s Qh 8h]
ICallForYou: bets $0.10
zodapoker: folds 
Uncalled bet ($0.10) returned to ICallForYou
ICallForYou collected $0.10 from pot
ICallForYou: doesn't show hand 
*** SUMMARY ***
Total pot $0.10 | Rake $0 
Board [3s Qh 8h]
Seat 1: cherry006 (button) folded before Flop (didn't bet)
Seat 2: ICallForYou (small blind) collected ($0.10)
Seat 3: zodapoker (big blind) folded on the Flop
Seat 4: FakaN4Kavera folded before Flop (didn't bet)
Seat 5: YAG5292 folded before Flop (didn't bet)
Seat 6: intentii folded before Flop (didn't bet)



PokerStars Zoom Hand #257880049474:  Hold'em No Limit ($0.02/$0.05) - 2025/09/25 19:43:33 JST [2025/09/25 6:43:33 ET]
Table 'Donati' 6-max Seat #1 is the button
Seat 1: FakaN4Kavera ($6.37 in chips) 
Seat 2: Ingyeoking ($10.90 in chips) 
Seat 3: vlad.mdv ($4.93 in chips) 
Seat 4: elmex886 ($5.61 in chips) 
Seat 5: egoor199 ($5.71 in chips) 
Seat 6: IBRODIAN-ACER ($5 in chips) 
Ingyeoking: posts small blind $0.02
vlad.mdv: posts big blind $0.05
*** HOLE CARDS ***
Dealt to FakaN4Kavera [Qc Th]
elmex886: folds 
egoor199: folds 
IBRODIAN-ACER: folds 
FakaN4Kavera: raises $0.07 to $0.12
Ingyeoking: folds 
vlad.mdv: calls $0.07
*** FLOP *** [6h Ac 8s]
vlad.mdv: checks 
FakaN4Kavera: checks 
*** TURN *** [6h Ac 8s] [8d]
vlad.mdv: checks 
FakaN4Kavera: checks 
*** RIVER *** [6h Ac 8s 8d] [Tc]
vlad.mdv: checks 
FakaN4Kavera: checks 
*** SHOW DOWN ***
vlad.mdv: shows [Jc Kc] (a pair of Eights)
FakaN4Kavera: shows [Qc Th] (two pair, Tens and Eights)
FakaN4Kavera collected $0.25 from pot
*** SUMMARY ***
Total pot $0.26 | Rake $0.01 
Board [6h Ac 8s 8d Tc]
Seat 1: FakaN4Kavera (button) showed [Qc Th] and won ($0.25) with two pair, Tens and Eights
Seat 2: Ingyeoking (small blind) folded before Flop
Seat 3: vlad.mdv (big blind) showed [Jc Kc] and lost with a pair of Eights
Seat 4: elmex886 folded before Flop (didn't bet)
Seat 5: egoor199 folded before Flop (didn't bet)
Seat 6: IBRODIAN-ACER folded before Flop (didn't bet)



PokerStars Zoom Hand #257880054304:  Hold'em No Limit ($0.02/$0.05) - 2025/09/25 19:44:19 JST [2025/09/25 6:44:19 ET]
Table 'Donati' 6-max Seat #1 is the button
Seat 1: egoor199 ($6.37 in chips) 
Seat 2: intentii ($7.06 in chips) 
Seat 3: FakaN4Kavera ($6.50 in chips) 
Seat 4: KRSofM ($4.76 in chips) 
Seat 5: Coco_bear373 ($11.75 in chips) 
Seat 6: lefra9 ($5.13 in chips) 
intentii: posts small blind $0.02
FakaN4Kavera: posts big blind $0.05
*** HOLE CARDS ***
Dealt to FakaN4Kavera [Jc 4h]
KRSofM: folds 
Coco_bear373: folds 
lefra9: raises $0.10 to $0.15
egoor199: folds 
intentii: folds 
FakaN4Kavera: folds 
Uncalled bet ($0.10) returned to lefra9
lefra9 collected $0.12 from pot
lefra9: doesn't show hand 
*** SUMMARY ***
Total pot $0.12 | Rake $0 
Seat 1: egoor199 (button) folded before Flop (didn't bet)
Seat 2: intentii (small blind) folded before Flop
Seat 3: FakaN4Kavera (big blind) folded before Flop
Seat 4: KRSofM folded before Flop (didn't bet)
Seat 5: Coco_bear373 folded before Flop (didn't bet)
Seat 6: lefra9 collected ($0.12)



PokerStars Zoom Hand #257880053222:  Hold'em No Limit ($0.02/$0.05) - 2025/09/25 19:44:09 JST [2025/09/25 6:44:09 ET]
Table 'Donati' 6-max Seat #1 is the button
Seat 1: leakleakA ($11.87 in chips) 
Seat 2: vlad.mdv ($4.81 in chips) 
Seat 3: huyjokezy ($5.76 in chips) 
Seat 4: Vasco4430 ($7.88 in chips) 
Seat 5: Kenzo2211 ($5 in chips) 
Seat 6: FakaN4Kavera ($6.50 in chips) 
vlad.mdv: posts small blind $0.02
huyjokezy: posts big blind $0.05
*** HOLE CARDS ***
Dealt to FakaN4Kavera [Ad 6h]
Vasco4430: raises $0.10 to $0.15
Kenzo2211: folds 
FakaN4Kavera: folds 
leakleakA: folds 
vlad.mdv: calls $0.13
huyjokezy: calls $0.10
*** FLOP *** [Jh Qh Js]
vlad.mdv: checks 
huyjokezy: checks 
Vasco4430: checks 
*** TURN *** [Jh Qh Js] [4s]
vlad.mdv: checks 
huyjokezy: checks 
Vasco4430: bets $0.22
vlad.mdv: folds 
huyjokezy: calls $0.22
*** RIVER *** [Jh Qh Js 4s] [2h]
huyjokezy: checks 
Vasco4430: bets $0.43
huyjokezy: calls $0.43
*** SHOW DOWN ***
Vasco4430: shows [Ts As] (a pair of Jacks)
huyjokezy: shows [Jd 9d] (three of a kind, Jacks)
huyjokezy collected $1.68 from pot
*** SUMMARY ***
Total pot $1.75 | Rake $0.07 
Board [Jh Qh Js 4s 2h]
Seat 1: leakleakA (button) folded before Flop (didn't bet)
Seat 2: vlad.mdv (small blind) folded on the Turn
Seat 3: huyjokezy (big blind) showed [Jd 9d] and won ($1.68) with three of a kind, Jacks
Seat 4: Vasco4430 showed [Ts As] and lost with a pair of Jacks
Seat 5: Kenzo2211 folded before Flop (didn't bet)
Seat 6: FakaN4Kavera folded before Flop (didn't bet)



PokerStars Zoom Hand #257880055431:  Hold'em No Limit ($0.02/$0.05) - 2025/09/25 19:44:30 JST [2025/09/25 6:44:30 ET]
Table 'Donati' 6-max Seat #1 is the button
Seat 1: KRSofM ($4.74 in chips) 
Seat 2: FakaN4Kavera ($6.45 in chips) 
Seat 3: muhaaa3000 ($4.05 in chips) 
Seat 4: sv5555555 ($3.99 in chips) 
Seat 5: IBRODIAN-ACER ($5 in chips) 
Seat 6: Ingyeoking ($4.26 in chips) 
FakaN4Kavera: posts small blind $0.02
muhaaa3000: posts big blind $0.05
*** HOLE CARDS ***
Dealt to FakaN4Kavera [9d Kd]
sv5555555: folds 
IBRODIAN-ACER: raises $0.05 to $0.10
Ingyeoking: folds 
KRSofM: folds 
FakaN4Kavera: calls $0.08
muhaaa3000: folds 
*** FLOP *** [3c Td Ks]
FakaN4Kavera: checks 
IBRODIAN-ACER: checks 
*** TURN *** [3c Td Ks] [8d]
FakaN4Kavera: bets $0.12
IBRODIAN-ACER: folds 
Uncalled bet ($0.12) returned to FakaN4Kavera
FakaN4Kavera collected $0.24 from pot
FakaN4Kavera: doesn't show hand 
*** SUMMARY ***
Total pot $0.25 | Rake $0.01 
Board [3c Td Ks 8d]
Seat 1: KRSofM (button) folded before Flop (didn't bet)
Seat 2: FakaN4Kavera (small blind) collected ($0.24)
Seat 3: muhaaa3000 (big blind) folded before Flop
Seat 4: sv5555555 folded before Flop (didn't bet)
Seat 5: IBRODIAN-ACER folded on the Turn
Seat 6: Ingyeoking folded before Flop (didn't bet)



PokerStars Zoom Hand #257880053743:  Hold'em No Limit ($0.02/$0.05) - 2025/09/25 19:44:14 JST [2025/09/25 6:44:14 ET]
Table 'Donati' 6-max Seat #1 is the button
Seat 1: faithfulness ($5 in chips) 
Seat 2: Ingyeoking ($6.11 in chips) 
Seat 3: 1Kronos ($9.90 in chips) 
Seat 4: serg430606 ($5.46 in chips) 
Seat 5: FakaN4Kavera ($6.50 in chips) 
Seat 6: leakleakA ($11.87 in chips) 
Ingyeoking: posts small blind $0.02
1Kronos: posts big blind $0.05
*** HOLE CARDS ***
Dealt to FakaN4Kavera [Js 5c]
serg430606: folds 
FakaN4Kavera: folds 
leakleakA: folds 
faithfulness: folds 
Ingyeoking: raises $0.10 to $0.15
1Kronos: calls $0.10
*** FLOP *** [8s 3d Tc]
Ingyeoking: checks 
1Kronos: checks 
*** TURN *** [8s 3d Tc] [Td]
Ingyeoking: checks 
1Kronos: checks 
*** RIVER *** [8s 3d Tc Td] [Kd]
Ingyeoking: checks 
1Kronos: bets $0.10
Ingyeoking: folds 
Uncalled bet ($0.10) returned to 1Kronos
1Kronos collected $0.29 from pot
1Kronos: doesn't show hand 
*** SUMMARY ***
Total pot $0.30 | Rake $0.01 
Board [8s 3d Tc Td Kd]
Seat 1: faithfulness (button) folded before Flop (didn't bet)
Seat 2: Ingyeoking (small blind) folded on the River
Seat 3: 1Kronos (big blind) collected ($0.29)
Seat 4: serg430606 folded before Flop (didn't bet)
Seat 5: FakaN4Kavera folded before Flop (didn't bet)
Seat 6: leakleakA folded before Flop (didn't bet)



PokerStars Zoom Hand #257880059221:  Hold'em No Limit ($0.02/$0.05) - 2025/09/25 19:45:07 JST [2025/09/25 6:45:07 ET]
Table 'Donati' 6-max Seat #1 is the button
Seat 1: FakaN4Kavera ($6.59 in chips) 
Seat 2: YAG5292 ($3.33 in chips) 
Seat 3: serg430606 ($5.58 in chips) 
Seat 4: tomis1312 ($5.50 in chips) 
Seat 5: zodapoker ($6.85 in chips) 
Seat 6: Ingyeoking ($5.96 in chips) 
YAG5292: posts small blind $0.02
serg430606: posts big blind $0.05
*** HOLE CARDS ***
Dealt to FakaN4Kavera [2h Kh]
tomis1312: folds 
zodapoker: folds 
Ingyeoking: folds 
FakaN4Kavera: folds 
YAG5292: folds 
Uncalled bet ($0.03) returned to serg430606
serg430606 collected $0.04 from pot
serg430606: doesn't show hand 
*** SUMMARY ***
Total pot $0.04 | Rake $0 
Seat 1: FakaN4Kavera (button) folded before Flop (didn't bet)
Seat 2: YAG5292 (small blind) folded before Flop
Seat 3: serg430606 (big blind) collected ($0.04)
Seat 4: tomis1312 folded before Flop (didn't bet)
Seat 5: zodapoker folded before Flop (didn't bet)
Seat 6: Ingyeoking folded before Flop (didn't bet)



PokerStars Zoom Hand #257880060006:  Hold'em No Limit ($0.02/$0.05) - 2025/09/25 19:45:15 JST [2025/09/25 6:45:15 ET]
Table 'Donati' 6-max Seat #1 is the button
Seat 1: scottie4barnes ($3.88 in chips) 
Seat 2: FakaN4Kavera ($6.59 in chips) 
Seat 3: intentii ($5.12 in chips) 
Seat 4: goaßmaß-fips ($14.21 in chips) 
Seat 5: Ingyeoking ($5.96 in chips) 
Seat 6: Kenzo2211 ($5.78 in chips) 
FakaN4Kavera: posts small blind $0.02
intentii: posts big blind $0.05
*** HOLE CARDS ***
Dealt to FakaN4Kavera [Ad 3s]
goaßmaß-fips: folds 
Ingyeoking: folds 
Kenzo2211: folds 
scottie4barnes: folds 
FakaN4Kavera: raises $0.07 to $0.12
intentii: folds 
Uncalled bet ($0.07) returned to FakaN4Kavera
FakaN4Kavera collected $0.10 from pot
FakaN4Kavera: doesn't show hand 
*** SUMMARY ***
Total pot $0.10 | Rake $0 
Seat 1: scottie4barnes (button) folded before Flop (didn't bet)
Seat 2: FakaN4Kavera (small blind) collected ($0.10)
Seat 3: intentii (big blind) folded before Flop
Seat 4: goaßmaß-fips folded before Flop (didn't bet)
Seat 5: Ingyeoking folded before Flop (didn't bet)
Seat 6: Kenzo2211 folded before Flop (didn't bet)



PokerStars Zoom Hand #257880059606:  Hold'em No Limit ($0.02/$0.05) - 2025/09/25 19:45:11 JST [2025/09/25 6:45:11 ET]
Table 'Donati' 6-max Seat #1 is the button
Seat 1: YAG5292 ($3.31 in chips) 
Seat 2: huyjokezy ($10.22 in chips) 
Seat 3: zodapoker ($6.85 in chips) 
Seat 4: FakaN4Kavera ($6.59 in chips) 
Seat 5: goaßmaß-fips ($14.21 in chips) 
Seat 6: tomis1312 ($5.50 in chips) 
huyjokezy: posts small blind $0.02
zodapoker: posts big blind $0.05
*** HOLE CARDS ***
Dealt to FakaN4Kavera [8d 3c]
FakaN4Kavera: folds 
goaßmaß-fips: folds 
tomis1312: raises $0.07 to $0.12
YAG5292: raises $0.24 to $0.36
huyjokezy: folds 
zodapoker: folds 
tomis1312: folds 
Uncalled bet ($0.24) returned to YAG5292
YAG5292 collected $0.31 from pot
YAG5292: doesn't show hand 
*** SUMMARY ***
Total pot $0.31 | Rake $0 
Seat 1: YAG5292 (button) collected ($0.31)
Seat 2: huyjokezy (small blind) folded before Flop
Seat 3: zodapoker (big blind) folded before Flop
Seat 4: FakaN4Kavera folded before Flop (didn't bet)
Seat 5: goaßmaß-fips folded before Flop (didn't bet)
Seat 6: tomis1312 folded before Flop



PokerStars Zoom Hand #257880061808:  Hold'em No Limit ($0.02/$0.05) - 2025/09/25 19:45:32 JST [2025/09/25 6:45:32 ET]
Table 'Donati' 6-max Seat #1 is the button
Seat 1: zodapoker ($6.80 in chips) 
Seat 2: IBRODIAN-ACER ($5.12 in chips) 
Seat 3: FakaN4Kavera ($6.64 in chips) 
Seat 4: intentii ($5.07 in chips) 
Seat 5: Coco_bear373 ($11.70 in chips) 
Seat 6: 1Kronos ($5 in chips) 
IBRODIAN-ACER: posts small blind $0.02
FakaN4Kavera: posts big blind $0.05
*** HOLE CARDS ***
Dealt to FakaN4Kavera [4s 5c]
intentii: folds 
Coco_bear373: raises $0.07 to $0.12
1Kronos: folds 
zodapoker: raises $0.26 to $0.38
IBRODIAN-ACER: folds 
FakaN4Kavera: folds 
Coco_bear373: folds 
Uncalled bet ($0.26) returned to zodapoker
zodapoker collected $0.31 from pot
zodapoker: doesn't show hand 
*** SUMMARY ***
Total pot $0.31 | Rake $0 
Seat 1: zodapoker (button) collected ($0.31)
Seat 2: IBRODIAN-ACER (small blind) folded before Flop
Seat 3: FakaN4Kavera (big blind) folded before Flop
Seat 4: intentii folded before Flop (didn't bet)
Seat 5: Coco_bear373 folded before Flop
Seat 6: 1Kronos folded before Flop (didn't bet)



PokerStars Zoom Hand #257880064144:  Hold'em No Limit ($0.02/$0.05) - 2025/09/25 19:45:54 JST [2025/09/25 6:45:54 ET]
Table 'Donati' 6-max Seat #1 is the button
Seat 1: Epist461 ($6.80 in chips) 
Seat 2: sepik200 ($4.70 in chips) 
Seat 3: 1Kronos ($14.11 in chips) 
Seat 4: FakaN4Kavera ($6.59 in chips) 
Seat 5: elmex886 ($5 in chips) 
Seat 6: IBRODIAN-ACER ($5.10 in chips) 
sepik200: posts small blind $0.02
1Kronos: posts big blind $0.05
*** HOLE CARDS ***
Dealt to FakaN4Kavera [3c Jd]
FakaN4Kavera: folds 
elmex886: raises $0.10 to $0.15
IBRODIAN-ACER: folds 
Epist461: folds 
sepik200: folds 
1Kronos: folds 
Uncalled bet ($0.10) returned to elmex886
elmex886 collected $0.12 from pot
elmex886: doesn't show hand 
*** SUMMARY ***
Total pot $0.12 | Rake $0 
Seat 1: Epist461 (button) folded before Flop (didn't bet)
Seat 2: sepik200 (small blind) folded before Flop
Seat 3: 1Kronos (big blind) folded before Flop
Seat 4: FakaN4Kavera folded before Flop (didn't bet)
Seat 5: elmex886 collected ($0.12)
Seat 6: IBRODIAN-ACER folded before Flop (didn't bet)



PokerStars Zoom Hand #257880064823:  Hold'em No Limit ($0.02/$0.05) - 2025/09/25 19:46:00 JST [2025/09/25 6:46:00 ET]
Table 'Donati' 6-max Seat #1 is the button
Seat 1: FakaN4Kavera ($6.59 in chips) 
Seat 2: IBRODIAN-ACER ($5.04 in chips) 
Seat 3: semmely ($9.49 in chips) 
Seat 4: huyjokezy ($6.43 in chips) 
Seat 5: zodapoker ($6.99 in chips) 
Seat 6: KRSofM ($4.93 in chips) 
IBRODIAN-ACER: posts small blind $0.02
semmely: posts big blind $0.05
*** HOLE CARDS ***
Dealt to FakaN4Kavera [7h 8s]
huyjokezy: raises $0.10 to $0.15
zodapoker: folds 
KRSofM: folds 
FakaN4Kavera: folds 
IBRODIAN-ACER: folds 
semmely: folds 
Uncalled bet ($0.10) returned to huyjokezy
huyjokezy collected $0.12 from pot
huyjokezy: doesn't show hand 
*** SUMMARY ***
Total pot $0.12 | Rake $0 
Seat 1: FakaN4Kavera (button) folded before Flop (didn't bet)
Seat 2: IBRODIAN-ACER (small blind) folded before Flop
Seat 3: semmely (big blind) folded before Flop
Seat 4: huyjokezy collected ($0.12)
Seat 5: zodapoker folded before Flop (didn't bet)
Seat 6: KRSofM folded before Flop (didn't bet)



PokerStars Zoom Hand #257880065331:  Hold'em No Limit ($0.02/$0.05) - 2025/09/25 19:46:05 JST [2025/09/25 6:46:05 ET]
Table 'Donati' 6-max Seat #1 is the button
Seat 1: vlad.mdv ($4.06 in chips) 
Seat 2: faithfulness ($5.49 in chips) 
Seat 3: copperfield ($3.31 in chips) 
Seat 4: zodapoker ($6.99 in chips) 
Seat 5: FakaN4Kavera ($6.59 in chips) 
Seat 6: Epist461 ($6.52 in chips) 
faithfulness: posts small blind $0.02
copperfield: posts big blind $0.05
*** HOLE CARDS ***
Dealt to FakaN4Kavera [Ks 7d]
zodapoker: folds 
FakaN4Kavera: folds 
Epist461: folds 
vlad.mdv: folds 
faithfulness: folds 
Uncalled bet ($0.03) returned to copperfield
copperfield collected $0.04 from pot
copperfield: doesn't show hand 
*** SUMMARY ***
Total pot $0.04 | Rake $0 
Seat 1: vlad.mdv (button) folded before Flop (didn't bet)
Seat 2: faithfulness (small blind) folded before Flop
Seat 3: copperfield (big blind) collected ($0.04)
Seat 4: zodapoker folded before Flop (didn't bet)
Seat 5: FakaN4Kavera folded before Flop (didn't bet)
Seat 6: Epist461 folded before Flop (didn't bet)



PokerStars Zoom Hand #257880063735:  Hold'em No Limit ($0.02/$0.05) - 2025/09/25 19:45:50 JST [2025/09/25 6:45:50 ET]
Table 'Donati' 6-max Seat #1 is the button
Seat 1: egoor199 ($5.89 in chips) 
Seat 2: KRSofM ($4.95 in chips) 
Seat 3: faithfulness ($5 in chips) 
Seat 4: IBRODIAN-ACER ($5.10 in chips) 
Seat 5: Kenzo2211 ($5.76 in chips) 
Seat 6: FakaN4Kavera ($6.59 in chips) 
KRSofM: posts small blind $0.02
faithfulness: posts big blind $0.05
*** HOLE CARDS ***
Dealt to FakaN4Kavera [7d 8c]
IBRODIAN-ACER: folds 
Kenzo2211: folds 
FakaN4Kavera: folds 
egoor199: raises $0.05 to $0.10
KRSofM: folds 
faithfulness: calls $0.05
*** FLOP *** [7c 3s 3c]
faithfulness: checks 
egoor199: bets $0.07
faithfulness: raises $0.21 to $0.28
egoor199: folds 
Uncalled bet ($0.21) returned to faithfulness
faithfulness collected $0.35 from pot
faithfulness: doesn't show hand 
*** SUMMARY ***
Total pot $0.36 | Rake $0.01 
Board [7c 3s 3c]
Seat 1: egoor199 (button) folded on the Flop
Seat 2: KRSofM (small blind) folded before Flop
Seat 3: faithfulness (big blind) collected ($0.35)
Seat 4: IBRODIAN-ACER folded before Flop (didn't bet)
Seat 5: Kenzo2211 folded before Flop (didn't bet)
Seat 6: FakaN4Kavera folded before Flop (didn't bet)



PokerStars Zoom Hand #257880065956:  Hold'em No Limit ($0.02/$0.05) - 2025/09/25 19:46:11 JST [2025/09/25 6:46:11 ET]
Table 'Donati' 6-max Seat #1 is the button
Seat 1: IBRODIAN-ACER ($5.02 in chips) 
Seat 2: zodapoker ($6.99 in chips) 
Seat 3: serg430606 ($5.75 in chips) 
Seat 4: YAG5292 ($12.05 in chips) 
Seat 5: Ingyeoking ($5.45 in chips) 
Seat 6: FakaN4Kavera ($6.59 in chips) 
zodapoker: posts small blind $0.02
serg430606: posts big blind $0.05
*** HOLE CARDS ***
Dealt to FakaN4Kavera [Qh 7h]
YAG5292: folds 
Ingyeoking: raises $0.05 to $0.10
FakaN4Kavera: folds 
IBRODIAN-ACER: folds 
zodapoker: folds 
serg430606: folds 
Uncalled bet ($0.05) returned to Ingyeoking
Ingyeoking collected $0.12 from pot
Ingyeoking: doesn't show hand 
*** SUMMARY ***
Total pot $0.12 | Rake $0 
Seat 1: IBRODIAN-ACER (button) folded before Flop (didn't bet)
Seat 2: zodapoker (small blind) folded before Flop
Seat 3: serg430606 (big blind) folded before Flop
Seat 4: YAG5292 folded before Flop (didn't bet)
Seat 5: Ingyeoking collected ($0.12)
Seat 6: FakaN4Kavera folded before Flop (didn't bet)



PokerStars Zoom Hand #257880066765:  Hold'em No Limit ($0.02/$0.05) - 2025/09/25 19:46:19 JST [2025/09/25 6:46:19 ET]
Table 'Donati' 6-max Seat #1 is the button
Seat 1: intentii ($5.05 in chips) 
Seat 2: copperfield ($3.33 in chips) 
Seat 3: Irrubikajs ($8 in chips) 
Seat 4: Ingyeoking ($5.84 in chips) 
Seat 5: FakaN4Kavera ($6.59 in chips) 
Seat 6: IBRODIAN-ACER ($5.12 in chips) 
copperfield: posts small blind $0.02
Irrubikajs: posts big blind $0.05
*** HOLE CARDS ***
Dealt to FakaN4Kavera [Jh Kc]
Ingyeoking: folds 
FakaN4Kavera: raises $0.07 to $0.12
IBRODIAN-ACER: calls $0.12
intentii: raises $0.48 to $0.60
copperfield: folds 
Irrubikajs: folds 
FakaN4Kavera: folds 
IBRODIAN-ACER: folds 
Uncalled bet ($0.48) returned to intentii
intentii collected $0.43 from pot
intentii: doesn't show hand 
*** SUMMARY ***
Total pot $0.43 | Rake $0 
Seat 1: intentii (button) collected ($0.43)
Seat 2: copperfield (small blind) folded before Flop
Seat 3: Irrubikajs (big blind) folded before Flop
Seat 4: Ingyeoking folded before Flop (didn't bet)
Seat 5: FakaN4Kavera folded before Flop
Seat 6: IBRODIAN-ACER folded before Flop



PokerStars Zoom Hand #257880068795:  Hold'em No Limit ($0.02/$0.05) - 2025/09/25 19:46:38 JST [2025/09/25 6:46:38 ET]
Table 'Donati' 6-max Seat #1 is the button
Seat 1: IBRODIAN-ACER ($5 in chips) 
Seat 2: faithfulness ($5 in chips) 
Seat 3: YAG5292 ($3.43 in chips) 
Seat 4: FakaN4Kavera ($6.47 in chips) 
Seat 5: Baikasas ($5 in chips) 
Seat 6: KRSofM ($4.93 in chips) 
faithfulness: posts small blind $0.02
YAG5292: posts big blind $0.05
*** HOLE CARDS ***
Dealt to FakaN4Kavera [7h Td]
FakaN4Kavera: folds 
Baikasas: folds 
KRSofM: raises $0.07 to $0.12
IBRODIAN-ACER: folds 
faithfulness: folds 
YAG5292: calls $0.07
*** FLOP *** [5d 4s Qh]
YAG5292: checks 
KRSofM: bets $0.13
YAG5292: folds 
Uncalled bet ($0.13) returned to KRSofM
KRSofM collected $0.25 from pot
KRSofM: doesn't show hand 
*** SUMMARY ***
Total pot $0.26 | Rake $0.01 
Board [5d 4s Qh]
Seat 1: IBRODIAN-ACER (button) folded before Flop (didn't bet)
Seat 2: faithfulness (small blind) folded before Flop
Seat 3: YAG5292 (big blind) folded on the Flop
Seat 4: FakaN4Kavera folded before Flop (didn't bet)
Seat 5: Baikasas folded before Flop (didn't bet)
Seat 6: KRSofM collected ($0.25)



PokerStars Zoom Hand #257880069411:  Hold'em No Limit ($0.02/$0.05) - 2025/09/25 19:46:44 JST [2025/09/25 6:46:44 ET]
Table 'Donati' 6-max Seat #1 is the button
Seat 1: YAG5292 ($7.40 in chips) 
Seat 2: Vasco4430 ($8.25 in chips) 
Seat 3: FakaN4Kavera ($6.47 in chips) 
Seat 4: egoor199 ($5.62 in chips) 
Seat 5: faithfulness ($5.14 in chips) 
Seat 6: Kenzo2211 ($5.17 in chips) 
Vasco4430: posts small blind $0.02
FakaN4Kavera: posts big blind $0.05
*** HOLE CARDS ***
Dealt to FakaN4Kavera [7h 8h]
egoor199: folds 
faithfulness: folds 
Kenzo2211: folds 
YAG5292: raises $0.09 to $0.14
Vasco4430: folds 
FakaN4Kavera: calls $0.09
*** FLOP *** [8c 7d Ks]
FakaN4Kavera: checks 
YAG5292: checks 
*** TURN *** [8c 7d Ks] [As]
FakaN4Kavera: bets $0.22
YAG5292: folds 
Uncalled bet ($0.22) returned to FakaN4Kavera
FakaN4Kavera collected $0.29 from pot
FakaN4Kavera: doesn't show hand 
*** SUMMARY ***
Total pot $0.30 | Rake $0.01 
Board [8c 7d Ks As]
Seat 1: YAG5292 (button) folded on the Turn
Seat 2: Vasco4430 (small blind) folded before Flop
Seat 3: FakaN4Kavera (big blind) collected ($0.29)
Seat 4: egoor199 folded before Flop (didn't bet)
Seat 5: faithfulness folded before Flop (didn't bet)
Seat 6: Kenzo2211 folded before Flop (didn't bet)



PokerStars Zoom Hand #257880072744:  Hold'em No Limit ($0.02/$0.05) - 2025/09/25 19:47:16 JST [2025/09/25 6:47:16 ET]
Table 'Donati' 6-max Seat #1 is the button
Seat 1: egoor199 ($5.55 in chips) 
Seat 2: FakaN4Kavera ($6.62 in chips) 
Seat 3: Vasco4430 ($8.23 in chips) 
Seat 4: faithfulness ($5.23 in chips) 
Seat 5: 1Kronos ($9.90 in chips) 
Seat 6: Ingyeoking ($10.77 in chips) 
FakaN4Kavera: posts small blind $0.02
Vasco4430: posts big blind $0.05
*** HOLE CARDS ***
Dealt to FakaN4Kavera [Qs 7d]
faithfulness: folds 
1Kronos: folds 
Ingyeoking: raises $0.07 to $0.12
egoor199: folds 
FakaN4Kavera: folds 
Vasco4430: calls $0.07
*** FLOP *** [2s As 9h]
Vasco4430: checks 
Ingyeoking: bets $0.08
Vasco4430: folds 
Uncalled bet ($0.08) returned to Ingyeoking
Ingyeoking collected $0.25 from pot
Ingyeoking: doesn't show hand 
*** SUMMARY ***
Total pot $0.26 | Rake $0.01 
Board [2s As 9h]
Seat 1: egoor199 (button) folded before Flop (didn't bet)
Seat 2: FakaN4Kavera (small blind) folded before Flop
Seat 3: Vasco4430 (big blind) folded on the Flop
Seat 4: faithfulness folded before Flop (didn't bet)
Seat 5: 1Kronos folded before Flop (didn't bet)
Seat 6: Ingyeoking collected ($0.25)



PokerStars Zoom Hand #257880075256:  Hold'em No Limit ($0.02/$0.05) - 2025/09/25 19:47:41 JST [2025/09/25 6:47:41 ET]
Table 'Donati' 6-max Seat #1 is the button
Seat 1: Ingyeoking ($5.17 in chips) 
Seat 2: FakaN4Kavera ($6.60 in chips) 
Seat 3: vlad.mdv ($2.82 in chips) 
Seat 4: faithfulness ($5.28 in chips) 
Seat 5: goaßmaß-fips ($14.52 in chips) 
Seat 6: klevinjer ($5.82 in chips) 
FakaN4Kavera: posts small blind $0.02
vlad.mdv: posts big blind $0.05
*** HOLE CARDS ***
Dealt to FakaN4Kavera [Ad Tc]
faithfulness: raises $0.07 to $0.12
goaßmaß-fips: folds 
klevinjer: folds 
Ingyeoking: raises $0.25 to $0.37
FakaN4Kavera: folds 
vlad.mdv: folds 
faithfulness: folds 
Uncalled bet ($0.25) returned to Ingyeoking
Ingyeoking collected $0.31 from pot
Ingyeoking: doesn't show hand 
*** SUMMARY ***
Total pot $0.31 | Rake $0 
Seat 1: Ingyeoking (button) collected ($0.31)
Seat 2: FakaN4Kavera (small blind) folded before Flop
Seat 3: vlad.mdv (big blind) folded before Flop
Seat 4: faithfulness folded before Flop
Seat 5: goaßmaß-fips folded before Flop (didn't bet)
Seat 6: klevinjer folded before Flop (didn't bet)



PokerStars Zoom Hand #257880074629:  Hold'em No Limit ($0.02/$0.05) - 2025/09/25 19:47:35 JST [2025/09/25 6:47:35 ET]
Table 'Donati' 6-max Seat #1 is the button
Seat 1: FakaN4Kavera ($6.60 in chips) 
Seat 2: 1Kronos ($5.13 in chips) 
Seat 3: Kenzo2211 ($5.76 in chips) 
Seat 4: Irrubikajs ($7.49 in chips) 
Seat 5: KRSofM ($5 in chips) 
Seat 6: Ingyeoking ($5.77 in chips) 
1Kronos: posts small blind $0.02
Kenzo2211: posts big blind $0.05
*** HOLE CARDS ***
Dealt to FakaN4Kavera [Ts 8h]
Irrubikajs: folds 
KRSofM: folds 
Ingyeoking: folds 
FakaN4Kavera: folds 
1Kronos: raises $0.10 to $0.15
Kenzo2211: calls $0.10
*** FLOP *** [Th Qc 2d]
1Kronos: checks 
Kenzo2211: bets $0.10
1Kronos: folds 
Uncalled bet ($0.10) returned to Kenzo2211
Kenzo2211 collected $0.29 from pot
Kenzo2211: doesn't show hand 
*** SUMMARY ***
Total pot $0.30 | Rake $0.01 
Board [Th Qc 2d]
Seat 1: FakaN4Kavera (button) folded before Flop (didn't bet)
Seat 2: 1Kronos (small blind) folded on the Flop
Seat 3: Kenzo2211 (big blind) collected ($0.29)
Seat 4: Irrubikajs folded before Flop (didn't bet)
Seat 5: KRSofM folded before Flop (didn't bet)
Seat 6: Ingyeoking folded before Flop (didn't bet)



PokerStars Zoom Hand #257880077262:  Hold'em No Limit ($0.02/$0.05) - 2025/09/25 19:48:00 JST [2025/09/25 6:48:00 ET]
Table 'Donati' 6-max Seat #1 is the button
Seat 1: Coco_bear373 ($11.53 in chips) 
Seat 2: IBRODIAN-ACER ($5.02 in chips) 
Seat 3: faithfulness ($5.16 in chips) 
Seat 4: KRSofM ($4.98 in chips) 
Seat 5: semmely ($9.93 in chips) 
Seat 6: FakaN4Kavera ($6.58 in chips) 
IBRODIAN-ACER: posts small blind $0.02
faithfulness: posts big blind $0.05
*** HOLE CARDS ***
Dealt to FakaN4Kavera [Kd 5d]
KRSofM: folds 
semmely: folds 
FakaN4Kavera: folds 
Coco_bear373: folds 
IBRODIAN-ACER: raises $0.10 to $0.15
faithfulness: calls $0.10
*** FLOP *** [Kc Ks 9c]
IBRODIAN-ACER: bets $0.10
faithfulness: folds 
Uncalled bet ($0.10) returned to IBRODIAN-ACER
IBRODIAN-ACER collected $0.29 from pot
IBRODIAN-ACER: doesn't show hand 
*** SUMMARY ***
Total pot $0.30 | Rake $0.01 
Board [Kc Ks 9c]
Seat 1: Coco_bear373 (button) folded before Flop (didn't bet)
Seat 2: IBRODIAN-ACER (small blind) collected ($0.29)
Seat 3: faithfulness (big blind) folded on the Flop
Seat 4: KRSofM folded before Flop (didn't bet)
Seat 5: semmely folded before Flop (didn't bet)
Seat 6: FakaN4Kavera folded before Flop (didn't bet)



PokerStars Zoom Hand #257880078238:  Hold'em No Limit ($0.02/$0.05) - 2025/09/25 19:48:09 JST [2025/09/25 6:48:09 ET]
Table 'Donati' 6-max Seat #1 is the button
Seat 1: KRSofM ($4.92 in chips) 
Seat 2: skygger777 ($3.74 in chips) 
Seat 3: FakaN4Kavera ($6.58 in chips) 
Seat 4: Kenzo2211 ($5.90 in chips) 
Seat 5: Ingyeoking ($5.36 in chips) 
Seat 6: Coco_bear373 ($11.53 in chips) 
skygger777: posts small blind $0.02
FakaN4Kavera: posts big blind $0.05
*** HOLE CARDS ***
Dealt to FakaN4Kavera [2d Qs]
Kenzo2211: folds 
Ingyeoking: raises $0.05 to $0.10
Coco_bear373: folds 
KRSofM: folds 
skygger777: calls $0.08
FakaN4Kavera: folds 
*** FLOP *** [7h 2c 5h]
skygger777: checks 
Ingyeoking: checks 
*** TURN *** [7h 2c 5h] [4c]
skygger777: bets $0.10
Ingyeoking: folds 
Uncalled bet ($0.10) returned to skygger777
skygger777 collected $0.24 from pot
skygger777: doesn't show hand 
*** SUMMARY ***
Total pot $0.25 | Rake $0.01 
Board [7h 2c 5h 4c]
Seat 1: KRSofM (button) folded before Flop (didn't bet)
Seat 2: skygger777 (small blind) collected ($0.24)
Seat 3: FakaN4Kavera (big blind) folded before Flop
Seat 4: Kenzo2211 folded before Flop (didn't bet)
Seat 5: Ingyeoking folded on the Turn
Seat 6: Coco_bear373 folded before Flop (didn't bet)



PokerStars Zoom Hand #257880079608:  Hold'em No Limit ($0.02/$0.05) - 2025/09/25 19:48:22 JST [2025/09/25 6:48:22 ET]
Table 'Donati' 6-max Seat #1 is the button
Seat 1: semmely ($9.95 in chips) 
Seat 2: 1Kronos ($13.99 in chips) 
Seat 3: vlad.mdv ($2.75 in chips) 
Seat 4: FakaN4Kavera ($6.53 in chips) 
Seat 5: KRSofM ($4.92 in chips) 
Seat 6: JamesTiernan09 ($4.91 in chips) 
1Kronos: posts small blind $0.02
vlad.mdv: posts big blind $0.05
*** HOLE CARDS ***
Dealt to FakaN4Kavera [2h 3h]
FakaN4Kavera: folds 
KRSofM: folds 
JamesTiernan09 has timed out
JamesTiernan09: folds 
semmely: folds 
1Kronos: folds 
Uncalled bet ($0.03) returned to vlad.mdv
vlad.mdv collected $0.04 from pot
vlad.mdv: doesn't show hand 
*** SUMMARY ***
Total pot $0.04 | Rake $0 
Seat 1: semmely (button) folded before Flop (didn't bet)
Seat 2: 1Kronos (small blind) folded before Flop
Seat 3: vlad.mdv (big blind) collected ($0.04)
Seat 4: FakaN4Kavera folded before Flop (didn't bet)
Seat 5: KRSofM folded before Flop (didn't bet)
Seat 6: JamesTiernan09 folded before Flop (didn't bet)



PokerStars Zoom Hand #257880083004:  Hold'em No Limit ($0.02/$0.05) - 2025/09/25 19:48:55 JST [2025/09/25 6:48:55 ET]
Table 'Donati' 6-max Seat #1 is the button
Seat 1: Epist461 ($6.80 in chips) 
Seat 2: semmely ($9.95 in chips) 
Seat 3: Tartarobass ($5 in chips) 
Seat 4: zodapoker ($8.49 in chips) 
Seat 5: skygger777 ($4.35 in chips) 
Seat 6: FakaN4Kavera ($6.53 in chips) 
semmely: posts small blind $0.02
Tartarobass: posts big blind $0.05
*** HOLE CARDS ***
Dealt to FakaN4Kavera [2c Ah]
zodapoker: folds 
skygger777: folds 
FakaN4Kavera: raises $0.07 to $0.12
Epist461: folds 
semmely: folds 
Tartarobass: folds 
Uncalled bet ($0.07) returned to FakaN4Kavera
FakaN4Kavera collected $0.12 from pot
FakaN4Kavera: doesn't show hand 
*** SUMMARY ***
Total pot $0.12 | Rake $0 
Seat 1: Epist461 (button) folded before Flop (didn't bet)
Seat 2: semmely (small blind) folded before Flop
Seat 3: Tartarobass (big blind) folded before Flop
Seat 4: zodapoker folded before Flop (didn't bet)
Seat 5: skygger777 folded before Flop (didn't bet)
Seat 6: FakaN4Kavera collected ($0.12)



PokerStars Zoom Hand #257880082717:  Hold'em No Limit ($0.02/$0.05) - 2025/09/25 19:48:52 JST [2025/09/25 6:48:52 ET]
Table 'Donati' 6-max Seat #1 is the button
Seat 1: intentii ($6.86 in chips) 
Seat 2: St4ut ($5.32 in chips) 
Seat 3: 1Kronos ($13.97 in chips) 
Seat 4: FakaN4Kavera ($6.53 in chips) 
Seat 5: egoor199 ($5.48 in chips) 
Seat 6: Kenbunshoku ($13.37 in chips) 
St4ut: posts small blind $0.02
1Kronos: posts big blind $0.05
*** HOLE CARDS ***
Dealt to FakaN4Kavera [Kc 9s]
FakaN4Kavera: folds 
egoor199: folds 
Kenbunshoku: folds 
intentii: raises $0.08 to $0.13
St4ut: folds 
1Kronos: folds 
Uncalled bet ($0.08) returned to intentii
intentii collected $0.12 from pot
intentii: doesn't show hand 
*** SUMMARY ***
Total pot $0.12 | Rake $0 
Seat 1: intentii (button) collected ($0.12)
Seat 2: St4ut (small blind) folded before Flop
Seat 3: 1Kronos (big blind) folded before Flop
Seat 4: FakaN4Kavera folded before Flop (didn't bet)
Seat 5: egoor199 folded before Flop (didn't bet)
Seat 6: Kenbunshoku folded before Flop (didn't bet)



PokerStars Zoom Hand #257880081911:  Hold'em No Limit ($0.02/$0.05) - 2025/09/25 19:48:44 JST [2025/09/25 6:48:44 ET]
Table 'Donati' 6-max Seat #1 is the button
Seat 1: FakaN4Kavera ($6.53 in chips) 
Seat 2: YAG5292 ($9.41 in chips) 
Seat 3: Ingyeoking ($10.88 in chips) 
Seat 4: Baikasas ($5.03 in chips) 
Seat 5: Kenzo2211 ($5.95 in chips) 
Seat 6: 1Kronos ($13.97 in chips) 
YAG5292: posts small blind $0.02
Ingyeoking: posts big blind $0.05
*** HOLE CARDS ***
Dealt to FakaN4Kavera [3c Ks]
Baikasas: raises $0.10 to $0.15
Kenzo2211: folds 
1Kronos: folds 
FakaN4Kavera: folds 
YAG5292: calls $0.13
Ingyeoking: folds 
*** FLOP *** [Td Ac Ad]
YAG5292: checks 
Baikasas: checks 
*** TURN *** [Td Ac Ad] [8h]
YAG5292: bets $0.17
Baikasas: folds 
Uncalled bet ($0.17) returned to YAG5292
YAG5292 collected $0.34 from pot
YAG5292: doesn't show hand 
*** SUMMARY ***
Total pot $0.35 | Rake $0.01 
Board [Td Ac Ad 8h]
Seat 1: FakaN4Kavera (button) folded before Flop (didn't bet)
Seat 2: YAG5292 (small blind) collected ($0.34)
Seat 3: Ingyeoking (big blind) folded before Flop
Seat 4: Baikasas folded on the Turn
Seat 5: Kenzo2211 folded before Flop (didn't bet)
Seat 6: 1Kronos folded before Flop (didn't bet)



PokerStars Zoom Hand #257880084390:  Hold'em No Limit ($0.02/$0.05) - 2025/09/25 19:49:08 JST [2025/09/25 6:49:08 ET]
Table 'Donati' 6-max Seat #1 is the button
Seat 1: Kenzo2211 ($5.95 in chips) 
Seat 2: KRSofM ($4.87 in chips) 
Seat 3: intentii ($5.60 in chips) 
Seat 4: FakaN4Kavera ($6.60 in chips) 
Seat 5: 1Kronos ($13.92 in chips) 
Seat 6: IBRODIAN-ACER ($5.60 in chips) 
KRSofM: posts small blind $0.02
intentii: posts big blind $0.05
*** HOLE CARDS ***
Dealt to FakaN4Kavera [7c 9h]
FakaN4Kavera: folds 
1Kronos: folds 
IBRODIAN-ACER: folds 
Kenzo2211: raises $0.05 to $0.10
KRSofM: folds 
intentii: folds 
Uncalled bet ($0.05) returned to Kenzo2211
Kenzo2211 collected $0.12 from pot
Kenzo2211: doesn't show hand 
*** SUMMARY ***
Total pot $0.12 | Rake $0 
Seat 1: Kenzo2211 (button) collected ($0.12)
Seat 2: KRSofM (small blind) folded before Flop
Seat 3: intentii (big blind) folded before Flop
Seat 4: FakaN4Kavera folded before Flop (didn't bet)
Seat 5: 1Kronos folded before Flop (didn't bet)
Seat 6: IBRODIAN-ACER folded before Flop (didn't bet)



PokerStars Zoom Hand #257880080441:  Hold'em No Limit ($0.02/$0.05) - 2025/09/25 19:48:30 JST [2025/09/25 6:48:30 ET]
Table 'Donati' 6-max Seat #1 is the button
Seat 1: Baikasas ($5.03 in chips) 
Seat 2: Ingyeoking ($5.70 in chips) 
Seat 3: IBRODIAN-ACER ($5.80 in chips) 
Seat 4: zodapoker ($7.04 in chips) 
Seat 5: FakaN4Kavera ($6.53 in chips) 
Seat 6: Schöngeist71 ($12.77 in chips) 
Ingyeoking: posts small blind $0.02
IBRODIAN-ACER: posts big blind $0.05
*** HOLE CARDS ***
Dealt to FakaN4Kavera [6c Kc]
zodapoker: raises $0.07 to $0.12
FakaN4Kavera: folds 
Schöngeist71: folds 
Baikasas: folds 
Ingyeoking: raises $0.48 to $0.60
IBRODIAN-ACER: folds 
zodapoker: calls $0.48
*** FLOP *** [9d 4c 3s]
Ingyeoking: checks 
zodapoker: checks 
*** TURN *** [9d 4c 3s] [Jh]
Ingyeoking: bets $0.60
zodapoker: calls $0.60
*** RIVER *** [9d 4c 3s Jh] [Qc]
Ingyeoking: checks 
zodapoker: checks 
*** SHOW DOWN ***
Ingyeoking: shows [As Jc] (a pair of Jacks)
zodapoker: shows [Jd Ad] (a pair of Jacks)
Ingyeoking collected $1.18 from pot
zodapoker collected $1.17 from pot
*** SUMMARY ***
Total pot $2.45 | Rake $0.10 
Board [9d 4c 3s Jh Qc]
Seat 1: Baikasas (button) folded before Flop (didn't bet)
Seat 2: Ingyeoking (small blind) showed [As Jc] and won ($1.18) with a pair of Jacks
Seat 3: IBRODIAN-ACER (big blind) folded before Flop
Seat 4: zodapoker showed [Jd Ad] and won ($1.17) with a pair of Jacks
Seat 5: FakaN4Kavera folded before Flop (didn't bet)
Seat 6: Schöngeist71 folded before Flop (didn't bet)



PokerStars Zoom Hand #257880085153:  Hold'em No Limit ($0.02/$0.05) - 2025/09/25 19:49:15 JST [2025/09/25 6:49:15 ET]
Table 'Donati' 6-max Seat #1 is the button
Seat 1: 1Kronos ($5 in chips) 
Seat 2: FakaN4Kavera ($6.60 in chips) 
Seat 3: IBRODIAN-ACER ($5.60 in chips) 
Seat 4: skygger777 ($4.35 in chips) 
Seat 5: sepik200 ($5.07 in chips) 
Seat 6: Tartarobass ($5 in chips) 
FakaN4Kavera: posts small blind $0.02
IBRODIAN-ACER: posts big blind $0.05
*** HOLE CARDS ***
Dealt to FakaN4Kavera [8h 8s]
skygger777: folds 
sepik200: raises $0.05 to $0.10
Tartarobass: folds 
1Kronos: folds 
FakaN4Kavera: calls $0.08
IBRODIAN-ACER: folds 
*** FLOP *** [Jc Qd 7c]
FakaN4Kavera: checks 
sepik200: bets $0.12
FakaN4Kavera: folds 
Uncalled bet ($0.12) returned to sepik200
sepik200 collected $0.24 from pot
sepik200: doesn't show hand 
*** SUMMARY ***
Total pot $0.25 | Rake $0.01 
Board [Jc Qd 7c]
Seat 1: 1Kronos (button) folded before Flop (didn't bet)
Seat 2: FakaN4Kavera (small blind) folded on the Flop
Seat 3: IBRODIAN-ACER (big blind) folded before Flop
Seat 4: skygger777 folded before Flop (didn't bet)
Seat 5: sepik200 collected ($0.24)
Seat 6: Tartarobass folded before Flop (didn't bet)



PokerStars Zoom Hand #257880089866:  Hold'em No Limit ($0.02/$0.05) - 2025/09/25 19:50:01 JST [2025/09/25 6:50:01 ET]
Table 'Donati' 6-max Seat #1 is the button
Seat 1: 1Kronos ($13.62 in chips) 
Seat 2: intentii ($5.45 in chips) 
Seat 3: faithfulness ($5 in chips) 
Seat 4: St4ut ($5.46 in chips) 
Seat 5: Epist461 ($6.80 in chips) 
Seat 6: FakaN4Kavera ($6.45 in chips) 
intentii: posts small blind $0.02
faithfulness: posts big blind $0.05
*** HOLE CARDS ***
Dealt to FakaN4Kavera [2d Ac]
St4ut: folds 
Epist461: folds 
FakaN4Kavera: folds 
1Kronos: folds 
intentii: raises $0.10 to $0.15
faithfulness: folds 
Uncalled bet ($0.10) returned to intentii
intentii collected $0.10 from pot
intentii: doesn't show hand 
*** SUMMARY ***
Total pot $0.10 | Rake $0 
Seat 1: 1Kronos (button) folded before Flop (didn't bet)
Seat 2: intentii (small blind) collected ($0.10)
Seat 3: faithfulness (big blind) folded before Flop
Seat 4: St4ut folded before Flop (didn't bet)
Seat 5: Epist461 folded before Flop (didn't bet)
Seat 6: FakaN4Kavera folded before Flop (didn't bet)



PokerStars Zoom Hand #257880090815:  Hold'em No Limit ($0.02/$0.05) - 2025/09/25 19:50:10 JST [2025/09/25 6:50:10 ET]
Table 'Donati' 6-max Seat #1 is the button
Seat 1: FakaN4Kavera ($6.45 in chips) 
Seat 2: semmely ($10.20 in chips) 
Seat 3: sk1bbz ($5 in chips) 
Seat 4: 1Kronos ($13.62 in chips) 
Seat 5: intentii ($5 in chips) 
Seat 6: faithfulness ($5.09 in chips) 
semmely: posts small blind $0.02
sk1bbz: posts big blind $0.05
*** HOLE CARDS ***
Dealt to FakaN4Kavera [6s Tc]
1Kronos: folds 
intentii: folds 
faithfulness: folds 
FakaN4Kavera: folds 
semmely: raises $0.05 to $0.10
sk1bbz: folds 
Uncalled bet ($0.05) returned to semmely
semmely collected $0.10 from pot
semmely: doesn't show hand 
*** SUMMARY ***
Total pot $0.10 | Rake $0 
Seat 1: FakaN4Kavera (button) folded before Flop (didn't bet)
Seat 2: semmely (small blind) collected ($0.10)
Seat 3: sk1bbz (big blind) folded before Flop
Seat 4: 1Kronos folded before Flop (didn't bet)
Seat 5: intentii folded before Flop (didn't bet)
Seat 6: faithfulness folded before Flop (didn't bet)



PokerStars Zoom Hand #257880087709:  Hold'em No Limit ($0.02/$0.05) - 2025/09/25 19:49:40 JST [2025/09/25 6:49:40 ET]
Table 'Donati' 6-max Seat #1 is the button
Seat 1: IBRODIAN-ACER ($5.53 in chips) 
Seat 2: faithfulness ($5 in chips) 
Seat 3: FakaN4Kavera ($6.50 in chips) 
Seat 4: franks270 ($13.09 in chips) 
Seat 5: KRSofM ($5.50 in chips) 
Seat 6: Ingyeoking ($5.33 in chips) 
faithfulness: posts small blind $0.02
FakaN4Kavera: posts big blind $0.05
*** HOLE CARDS ***
Dealt to FakaN4Kavera [5h As]
franks270 has timed out
franks270: folds 
KRSofM: folds 
Ingyeoking: raises $0.07 to $0.12
IBRODIAN-ACER: calls $0.12
faithfulness: folds 
FakaN4Kavera: folds 
*** FLOP *** [Ah 5s Kc]
Ingyeoking: checks 
IBRODIAN-ACER: checks 
*** TURN *** [Ah 5s Kc] [7h]
Ingyeoking: checks 
IBRODIAN-ACER: checks 
*** RIVER *** [Ah 5s Kc 7h] [Jd]
Ingyeoking: bets $0.15
IBRODIAN-ACER: folds 
Uncalled bet ($0.15) returned to Ingyeoking
Ingyeoking collected $0.30 from pot
Ingyeoking: doesn't show hand 
*** SUMMARY ***
Total pot $0.31 | Rake $0.01 
Board [Ah 5s Kc 7h Jd]
Seat 1: IBRODIAN-ACER (button) folded on the River
Seat 2: faithfulness (small blind) folded before Flop
Seat 3: FakaN4Kavera (big blind) folded before Flop
Seat 4: franks270 folded before Flop (didn't bet)
Seat 5: KRSofM folded before Flop (didn't bet)
Seat 6: Ingyeoking collected ($0.30)



PokerStars Zoom Hand #257880091972:  Hold'em No Limit ($0.02/$0.05) - 2025/09/25 19:50:21 JST [2025/09/25 6:50:21 ET]
Table 'Donati' 6-max Seat #1 is the button
Seat 1: intentii ($5.50 in chips) 
Seat 2: Ingyeoking ($11.67 in chips) 
Seat 3: FakaN4Kavera ($6.45 in chips) 
Seat 4: faithfulness ($5 in chips) 
Seat 5: 1Kronos ($5 in chips) 
Seat 6: sepik200 ($5.19 in chips) 
Ingyeoking: posts small blind $0.02
FakaN4Kavera: posts big blind $0.05
*** HOLE CARDS ***
Dealt to FakaN4Kavera [4d Kd]
faithfulness: folds 
1Kronos: folds 
sepik200: folds 
intentii: folds 
Ingyeoking: raises $0.10 to $0.15
FakaN4Kavera: folds 
Uncalled bet ($0.10) returned to Ingyeoking
Ingyeoking collected $0.10 from pot
Ingyeoking: doesn't show hand 
*** SUMMARY ***
Total pot $0.10 | Rake $0 
Seat 1: intentii (button) folded before Flop (didn't bet)
Seat 2: Ingyeoking (small blind) collected ($0.10)
Seat 3: FakaN4Kavera (big blind) folded before Flop
Seat 4: faithfulness folded before Flop (didn't bet)
Seat 5: 1Kronos folded before Flop (didn't bet)
Seat 6: sepik200 folded before Flop (didn't bet)



PokerStars Zoom Hand #257880094597:  Hold'em No Limit ($0.02/$0.05) - 2025/09/25 19:50:47 JST [2025/09/25 6:50:47 ET]
Table 'Donati' 6-max Seat #1 is the button
Seat 1: KRSofM ($4.89 in chips) 
Seat 2: FakaN4Kavera ($6.40 in chips) 
Seat 3: Gogart87 ($5.07 in chips) 
Seat 4: semmely ($10.25 in chips) 
Seat 5: klevinjer ($4.61 in chips) 
Seat 6: lebifflemaster ($7.01 in chips) 
FakaN4Kavera: posts small blind $0.02
Gogart87: posts big blind $0.05
*** HOLE CARDS ***
Dealt to FakaN4Kavera [9h 4s]
semmely: folds 
klevinjer: folds 
lebifflemaster: folds 
KRSofM: folds 
FakaN4Kavera: folds 
Uncalled bet ($0.03) returned to Gogart87
Gogart87 collected $0.04 from pot
Gogart87: doesn't show hand 
*** SUMMARY ***
Total pot $0.04 | Rake $0 
Seat 1: KRSofM (button) folded before Flop (didn't bet)
Seat 2: FakaN4Kavera (small blind) folded before Flop
Seat 3: Gogart87 (big blind) collected ($0.04)
Seat 4: semmely folded before Flop (didn't bet)
Seat 5: klevinjer folded before Flop (didn't bet)
Seat 6: lebifflemaster folded before Flop (didn't bet)



PokerStars Zoom Hand #257880097437:  Hold'em No Limit ($0.02/$0.05) - 2025/09/25 19:51:14 JST [2025/09/25 6:51:14 ET]
Table 'Donati' 6-max Seat #1 is the button
Seat 1: Kenzo2211 ($5.67 in chips) 
Seat 2: IBRODIAN-ACER ($5.03 in chips) 
Seat 3: Gogart87 ($7.70 in chips) 
Seat 4: 1Kronos ($9.78 in chips) 
Seat 5: FakaN4Kavera ($6.38 in chips) 
Seat 6: Epist461 ($6.55 in chips) 
IBRODIAN-ACER: posts small blind $0.02
Gogart87: posts big blind $0.05
*** HOLE CARDS ***
Dealt to FakaN4Kavera [5s 4c]
1Kronos: folds 
FakaN4Kavera: folds 
Epist461: folds 
Kenzo2211: folds 
IBRODIAN-ACER: folds 
Uncalled bet ($0.03) returned to Gogart87
Gogart87 collected $0.04 from pot
Gogart87: doesn't show hand 
*** SUMMARY ***
Total pot $0.04 | Rake $0 
Seat 1: Kenzo2211 (button) folded before Flop (didn't bet)
Seat 2: IBRODIAN-ACER (small blind) folded before Flop
Seat 3: Gogart87 (big blind) collected ($0.04)
Seat 4: 1Kronos folded before Flop (didn't bet)
Seat 5: FakaN4Kavera folded before Flop (didn't bet)
Seat 6: Epist461 folded before Flop (didn't bet)



