PokerStars Zoom Hand #257879891816:  Hold'em No Limit ($0.02/$0.05) - 2025/09/25 19:16:11 JST [2025/09/25 6:16:11 ET]
Table 'Donati' 6-max Seat #1 is the button
Seat 1: FakaN4Kavera ($5 in chips) 
Seat 2: YAG5292 ($4.83 in chips) 
Seat 3: Ingyeoking ($4.85 in chips) 
Seat 4: intentii ($5.34 in chips) 
Seat 5: Woidprophet ($6.50 in chips) 
Seat 6: bigdaveys ($11.64 in chips) 
YAG5292: posts small blind $0.02
Ingyeoking: posts big blind $0.05
*** HOLE CARDS ***
Dealt to FakaN4Kavera [2s 6s]
intentii: folds 
Woidprophet: raises $0.10 to $0.15
bigdaveys: folds 
FakaN4Kavera: folds 
YAG5292: folds 
Ingyeoking: folds 
Uncalled bet ($0.10) returned to Woidprophet
Woidprophet collected $0.12 from pot
Woidprophet: doesn't show hand 
*** SUMMARY ***
Total pot $0.12 | Rake $0 
Seat 1: FakaN4Kavera (button) folded before Flop (didn't bet)
Seat 2: YAG5292 (small blind) folded before Flop
Seat 3: Ingyeoking (big blind) folded before Flop
Seat 4: intentii folded before Flop (didn't bet)
Seat 5: Woidprophet collected ($0.12)
Seat 6: bigdaveys folded before Flop (didn't bet)



PokerStars Zoom Hand #257879892964:  Hold'em No Limit ($0.02/$0.05) - 2025/09/25 19:16:23 JST [2025/09/25 6:16:23 ET]
Table 'Donati' 6-max Seat #1 is the button
Seat 1: kmc4444 ($5.96 in chips) 
Seat 2: FakaN4Kavera ($5 in chips) 
Seat 3: delfinato200 ($14.04 in chips) 
Seat 4: Ingyeoking ($4.98 in chips) 
Seat 5: Kenzo2211 ($8.60 in chips) 
Seat 6: huyjokezy ($5 in chips) 
FakaN4Kavera: posts small blind $0.02
delfinato200: posts big blind $0.05
*** HOLE CARDS ***
Dealt to FakaN4Kavera [Kc 3c]
Ingyeoking: folds 
Kenzo2211: folds 
huyjokezy: folds 
kmc4444: raises $0.07 to $0.12
FakaN4Kavera: folds 
delfinato200: folds 
Uncalled bet ($0.07) returned to kmc4444
kmc4444 collected $0.12 from pot
kmc4444: doesn't show hand 
*** SUMMARY ***
Total pot $0.12 | Rake $0 
Seat 1: kmc4444 (button) collected ($0.12)
Seat 2: FakaN4Kavera (small blind) folded before Flop
Seat 3: delfinato200 (big blind) folded before Flop
Seat 4: Ingyeoking folded before Flop (didn't bet)
Seat 5: Kenzo2211 folded before Flop (didn't bet)
Seat 6: huyjokezy folded before Flop (didn't bet)



PokerStars Zoom Hand #257879891173:  Hold'em No Limit ($0.02/$0.05) - 2025/09/25 19:16:04 JST [2025/09/25 6:16:04 ET]
Table 'Donati' 6-max Seat #1 is the button
Seat 1: huyjokezy ($5 in chips) 
Seat 2: koshchey_a ($5.06 in chips) 
Seat 3: FakaN4Kavera ($5 in chips) 
Seat 4: P0KER_GR1ND ($5.25 in chips) 
Seat 5: Baikasas ($5 in chips) 
Seat 6: BretticusX ($5.90 in chips) 
koshchey_a: posts small blind $0.02
FakaN4Kavera: posts big blind $0.05
*** HOLE CARDS ***
Dealt to FakaN4Kavera [Qh 6c]
P0KER_GR1ND: folds 
Baikasas: raises $0.06 to $0.11
BretticusX: folds 
huyjokezy: calls $0.11
koshchey_a: folds 
FakaN4Kavera: folds 
*** FLOP *** [Ad 7s 3h]
Baikasas: checks 
huyjokezy: checks 
*** TURN *** [Ad 7s 3h] [2d]
Baikasas: checks 
huyjokezy: bets $0.14
Baikasas: folds 
Uncalled bet ($0.14) returned to huyjokezy
huyjokezy collected $0.28 from pot
huyjokezy: doesn't show hand 
*** SUMMARY ***
Total pot $0.29 | Rake $0.01 
Board [Ad 7s 3h 2d]
Seat 1: huyjokezy (button) collected ($0.28)
Seat 2: koshchey_a (small blind) folded before Flop
Seat 3: FakaN4Kavera (big blind) folded before Flop
Seat 4: P0KER_GR1ND folded before Flop (didn't bet)
Seat 5: Baikasas folded on the Turn
Seat 6: BretticusX folded before Flop (didn't bet)



PokerStars Zoom Hand #257879894363:  Hold'em No Limit ($0.02/$0.05) - 2025/09/25 19:16:38 JST [2025/09/25 6:16:38 ET]
Table 'Donati' 6-max Seat #1 is the button
Seat 1: bigdaveys ($11.60 in chips) 
Seat 2: Baikasas ($5 in chips) 
Seat 3: Ingyeoking ($5.85 in chips) 
Seat 4: gm__701 ($6.56 in chips) 
Seat 5: Woidprophet ($6.58 in chips) 
Seat 6: FakaN4Kavera ($5 in chips) 
Baikasas: posts small blind $0.02
Ingyeoking: posts big blind $0.05
*** HOLE CARDS ***
Dealt to FakaN4Kavera [Qs 3s]
gm__701: folds 
Woidprophet: folds 
FakaN4Kavera: folds 
bigdaveys: folds 
Baikasas: folds 
Uncalled bet ($0.03) returned to Ingyeoking
Ingyeoking collected $0.04 from pot
Ingyeoking: doesn't show hand 
*** SUMMARY ***
Total pot $0.04 | Rake $0 
Seat 1: bigdaveys (button) folded before Flop (didn't bet)
Seat 2: Baikasas (small blind) folded before Flop
Seat 3: Ingyeoking (big blind) collected ($0.04)
Seat 4: gm__701 folded before Flop (didn't bet)
Seat 5: Woidprophet folded before Flop (didn't bet)
Seat 6: FakaN4Kavera folded before Flop (didn't bet)



PokerStars Zoom Hand #257879894906:  Hold'em No Limit ($0.02/$0.05) - 2025/09/25 19:16:44 JST [2025/09/25 6:16:44 ET]
Table 'Donati' 6-max Seat #1 is the button
Seat 1: intentii ($5.27 in chips) 
Seat 2: BrickByBrick68 ($17.67 in chips) 
Seat 3: _jay_44_jas ($5.07 in chips) 
Seat 4: FakaN4Kavera ($5 in chips) 
Seat 5: huyjokezy ($5.07 in chips) 
Seat 6: KRSofM ($6.22 in chips) 
BrickByBrick68: posts small blind $0.02
_jay_44_jas: posts big blind $0.05
*** HOLE CARDS ***
Dealt to FakaN4Kavera [Js 6s]
FakaN4Kavera: folds 
huyjokezy: folds 
KRSofM: folds 
intentii: folds 
BrickByBrick68: folds 
Uncalled bet ($0.03) returned to _jay_44_jas
_jay_44_jas collected $0.04 from pot
_jay_44_jas: doesn't show hand 
*** SUMMARY ***
Total pot $0.04 | Rake $0 
Seat 1: intentii (button) folded before Flop (didn't bet)
Seat 2: BrickByBrick68 (small blind) folded before Flop
Seat 3: _jay_44_jas (big blind) collected ($0.04)
Seat 4: FakaN4Kavera folded before Flop (didn't bet)
Seat 5: huyjokezy folded before Flop (didn't bet)
Seat 6: KRSofM folded before Flop (didn't bet)



PokerStars Zoom Hand #257879895467:  Hold'em No Limit ($0.02/$0.05) - 2025/09/25 19:16:50 JST [2025/09/25 6:16:50 ET]
Table 'Donati' 6-max Seat #1 is the button
Seat 1: intentii ($5 in chips) 
Seat 2: FakaN4Kavera ($5 in chips) 
Seat 3: hatater ($6.09 in chips) 
Seat 4: Baikasas ($5.17 in chips) 
Seat 5: delfinato200 ($13.97 in chips) 
Seat 6: KRSofM ($5.45 in chips) 
FakaN4Kavera: posts small blind $0.02
hatater: posts big blind $0.05
*** HOLE CARDS ***
Dealt to FakaN4Kavera [Jd Qs]
Baikasas: folds 
delfinato200: folds 
KRSofM: folds 
intentii: folds 
FakaN4Kavera: folds 
Uncalled bet ($0.03) returned to hatater
hatater collected $0.04 from pot
hatater: doesn't show hand 
*** SUMMARY ***
Total pot $0.04 | Rake $0 
Seat 1: intentii (button) folded before Flop (didn't bet)
Seat 2: FakaN4Kavera (small blind) folded before Flop
Seat 3: hatater (big blind) collected ($0.04)
Seat 4: Baikasas folded before Flop (didn't bet)
Seat 5: delfinato200 folded before Flop (didn't bet)
Seat 6: KRSofM folded before Flop (didn't bet)



PokerStars Zoom Hand #257879896317:  Hold'em No Limit ($0.02/$0.05) - 2025/09/25 19:16:59 JST [2025/09/25 6:16:59 ET]
Table 'Donati' 6-max Seat #1 is the button
Seat 1: hatater ($5 in chips) 
Seat 2: KRSofM ($4.76 in chips) 
Seat 3: FakaN4Kavera ($5 in chips) 
Seat 4: kmc4444 ($6.10 in chips) 
Seat 5: bigdaveys ($11.55 in chips) 
Seat 6: Southpaw1331 ($3.16 in chips) 
KRSofM: posts small blind $0.02
FakaN4Kavera: posts big blind $0.05
*** HOLE CARDS ***
Dealt to FakaN4Kavera [6d 4s]
kmc4444: folds 
bigdaveys: folds 
Southpaw1331: calls $0.05
hatater: folds 
KRSofM: raises $0.15 to $0.20
FakaN4Kavera: folds 
Southpaw1331: calls $0.15
*** FLOP *** [Ks Js 8s]
KRSofM: bets $0.11
Southpaw1331: folds 
Uncalled bet ($0.11) returned to KRSofM
KRSofM collected $0.43 from pot
KRSofM: doesn't show hand 
*** SUMMARY ***
Total pot $0.45 | Rake $0.02 
Board [Ks Js 8s]
Seat 1: hatater (button) folded before Flop (didn't bet)
Seat 2: KRSofM (small blind) collected ($0.43)
Seat 3: FakaN4Kavera (big blind) folded before Flop
Seat 4: kmc4444 folded before Flop (didn't bet)
Seat 5: bigdaveys folded before Flop (didn't bet)
Seat 6: Southpaw1331 folded on the Flop



PokerStars Zoom Hand #257879897521:  Hold'em No Limit ($0.02/$0.05) - 2025/09/25 19:17:12 JST [2025/09/25 6:17:12 ET]
Table 'Donati' 6-max Seat #1 is the button
Seat 1: FakaN4Kavera ($5 in chips) 
Seat 2: Woidprophet ($5.19 in chips) 
Seat 3: Baikasas ($5.15 in chips) 
Seat 4: huyjokezy ($5 in chips) 
Seat 5: gio119 ($5.35 in chips) 
Seat 6: lebifflemaster ($6.14 in chips) 
Woidprophet: posts small blind $0.02
Baikasas: posts big blind $0.05
*** HOLE CARDS ***
Dealt to FakaN4Kavera [2h Ks]
huyjokezy: raises $0.10 to $0.15
gio119: folds 
lebifflemaster: raises $0.30 to $0.45
FakaN4Kavera: folds 
Woidprophet: folds 
Baikasas: folds 
huyjokezy: folds 
Uncalled bet ($0.30) returned to lebifflemaster
lebifflemaster collected $0.37 from pot
lebifflemaster: doesn't show hand 
*** SUMMARY ***
Total pot $0.37 | Rake $0 
Seat 1: FakaN4Kavera (button) folded before Flop (didn't bet)
Seat 2: Woidprophet (small blind) folded before Flop
Seat 3: Baikasas (big blind) folded before Flop
Seat 4: huyjokezy folded before Flop
Seat 5: gio119 folded before Flop (didn't bet)
Seat 6: lebifflemaster collected ($0.37)



PokerStars Zoom Hand #257879898284:  Hold'em No Limit ($0.02/$0.05) - 2025/09/25 19:17:20 JST [2025/09/25 6:17:20 ET]
Table 'Donati' 6-max Seat #1 is the button
Seat 1: Flauschefloc ($3.87 in chips) 
Seat 2: YAG5292 ($8.89 in chips) 
Seat 3: Southpaw1331 ($2.96 in chips) 
Seat 4: KRSofM ($6.27 in chips) 
Seat 5: hatater ($6.09 in chips) 
Seat 6: FakaN4Kavera ($5 in chips) 
YAG5292: posts small blind $0.02
Southpaw1331: posts big blind $0.05
*** HOLE CARDS ***
Dealt to FakaN4Kavera [4c Qh]
Flauschefloc is disconnected 
KRSofM: folds 
hatater: folds 
FakaN4Kavera: folds 
Flauschefloc has timed out while disconnected
Flauschefloc: folds 
YAG5292: folds 
Uncalled bet ($0.03) returned to Southpaw1331
Southpaw1331 collected $0.04 from pot
Southpaw1331: doesn't show hand 
*** SUMMARY ***
Total pot $0.04 | Rake $0 
Seat 1: Flauschefloc (button) folded before Flop (didn't bet)
Seat 2: YAG5292 (small blind) folded before Flop
Seat 3: Southpaw1331 (big blind) collected ($0.04)
Seat 4: KRSofM folded before Flop (didn't bet)
Seat 5: hatater folded before Flop (didn't bet)
Seat 6: FakaN4Kavera folded before Flop (didn't bet)



PokerStars Zoom Hand #257879898913:  Hold'em No Limit ($0.02/$0.05) - 2025/09/25 19:17:27 JST [2025/09/25 6:17:27 ET]
Table 'Donati' 6-max Seat #1 is the button
Seat 1: gio119 ($5.33 in chips) 
Seat 2: Ingyeoking ($5.10 in chips) 
Seat 3: leakleakA ($9.23 in chips) 
Seat 4: ElBrato421 ($5.10 in chips) 
Seat 5: FakaN4Kavera ($5 in chips) 
Seat 6: Baikasas ($5.10 in chips) 
Ingyeoking: posts small blind $0.02
leakleakA: posts big blind $0.05
*** HOLE CARDS ***
Dealt to FakaN4Kavera [3c Ac]
ElBrato421: folds 
FakaN4Kavera: raises $0.07 to $0.12
Baikasas: calls $0.12
gio119: folds 
Ingyeoking: folds 
leakleakA: folds 
*** FLOP *** [Th 8s 4s]
FakaN4Kavera: checks 
Baikasas: checks 
*** TURN *** [Th 8s 4s] [6d]
FakaN4Kavera: checks 
Baikasas: checks 
*** RIVER *** [Th 8s 4s 6d] [2c]
FakaN4Kavera: checks 
Baikasas: checks 
*** SHOW DOWN ***
FakaN4Kavera: shows [3c Ac] (high card Ace)
Baikasas: mucks hand 
FakaN4Kavera collected $0.30 from pot
*** SUMMARY ***
Total pot $0.31 | Rake $0.01 
Board [Th 8s 4s 6d 2c]
Seat 1: gio119 (button) folded before Flop (didn't bet)
Seat 2: Ingyeoking (small blind) folded before Flop
Seat 3: leakleakA (big blind) folded before Flop
Seat 4: ElBrato421 folded before Flop (didn't bet)
Seat 5: FakaN4Kavera showed [3c Ac] and won ($0.30) with high card Ace
Seat 6: Baikasas mucked [Ks Qh]



PokerStars Zoom Hand #257879903176:  Hold'em No Limit ($0.02/$0.05) - 2025/09/25 19:18:12 JST [2025/09/25 6:18:12 ET]
Table 'Donati' 6-max Seat #1 is the button
Seat 1: lebifflemaster ($7.74 in chips) 
Seat 2: kmc4444 ($6.03 in chips) 
Seat 3: 1Kronos ($16.04 in chips) 
Seat 4: gio119 ($5.28 in chips) 
Seat 5: FakaN4Kavera ($5.18 in chips) 
Seat 6: zodapoker ($5.35 in chips) 
kmc4444: posts small blind $0.02
1Kronos: posts big blind $0.05
*** HOLE CARDS ***
Dealt to FakaN4Kavera [Qc 4c]
gio119: folds 
FakaN4Kavera: folds 
zodapoker: folds 
lebifflemaster: raises $0.07 to $0.12
kmc4444: folds 
1Kronos: folds 
Uncalled bet ($0.07) returned to lebifflemaster
lebifflemaster collected $0.12 from pot
lebifflemaster: doesn't show hand 
*** SUMMARY ***
Total pot $0.12 | Rake $0 
Seat 1: lebifflemaster (button) collected ($0.12)
Seat 2: kmc4444 (small blind) folded before Flop
Seat 3: 1Kronos (big blind) folded before Flop
Seat 4: gio119 folded before Flop (didn't bet)
Seat 5: FakaN4Kavera folded before Flop (didn't bet)
Seat 6: zodapoker folded before Flop (didn't bet)



PokerStars Zoom Hand #257879903541:  Hold'em No Limit ($0.02/$0.05) - 2025/09/25 19:18:16 JST [2025/09/25 6:18:16 ET]
Table 'Donati' 6-max Seat #1 is the button
Seat 1: FakaN4Kavera ($5.18 in chips) 
Seat 2: Woidprophet ($6.58 in chips) 
Seat 3: YAG5292 ($5.32 in chips) 
Seat 4: kalopara ($7.98 in chips) 
Seat 5: kmc4444 ($6.24 in chips) 
Seat 6: VXNX$157 ($4.49 in chips) 
Woidprophet: posts small blind $0.02
YAG5292: posts big blind $0.05
*** HOLE CARDS ***
Dealt to FakaN4Kavera [6c Ah]
kalopara: folds 
kmc4444: folds 
VXNX$157: folds 
FakaN4Kavera: raises $0.07 to $0.12
Woidprophet: folds 
YAG5292: folds 
Uncalled bet ($0.07) returned to FakaN4Kavera
FakaN4Kavera collected $0.12 from pot
FakaN4Kavera: doesn't show hand 
*** SUMMARY ***
Total pot $0.12 | Rake $0 
Seat 1: FakaN4Kavera (button) collected ($0.12)
Seat 2: Woidprophet (small blind) folded before Flop
Seat 3: YAG5292 (big blind) folded before Flop
Seat 4: kalopara folded before Flop (didn't bet)
Seat 5: kmc4444 folded before Flop (didn't bet)
Seat 6: VXNX$157 folded before Flop (didn't bet)



PokerStars Zoom Hand #257879906216:  Hold'em No Limit ($0.02/$0.05) - 2025/09/25 19:18:44 JST [2025/09/25 6:18:44 ET]
Table 'Donati' 6-max Seat #1 is the button
Seat 1: gio119 ($9.81 in chips) 
Seat 2: _jay_44_jas ($5.57 in chips) 
Seat 3: FakaN4Kavera ($5.23 in chips) 
Seat 4: KRSofM ($4.94 in chips) 
Seat 5: Woidprophet ($6.56 in chips) 
Seat 6: intentii ($5.07 in chips) 
_jay_44_jas: posts small blind $0.02
FakaN4Kavera: posts big blind $0.05
*** HOLE CARDS ***
Dealt to FakaN4Kavera [Qh Jc]
KRSofM: folds 
Woidprophet: folds 
intentii: folds 
gio119: folds 
_jay_44_jas: folds 
Uncalled bet ($0.03) returned to FakaN4Kavera
FakaN4Kavera collected $0.04 from pot
FakaN4Kavera: doesn't show hand 
*** SUMMARY ***
Total pot $0.04 | Rake $0 
Seat 1: gio119 (button) folded before Flop (didn't bet)
Seat 2: _jay_44_jas (small blind) folded before Flop
Seat 3: FakaN4Kavera (big blind) collected ($0.04)
Seat 4: KRSofM folded before Flop (didn't bet)
Seat 5: Woidprophet folded before Flop (didn't bet)
Seat 6: intentii folded before Flop (didn't bet)



PokerStars Zoom Hand #257879905380:  Hold'em No Limit ($0.02/$0.05) - 2025/09/25 19:18:35 JST [2025/09/25 6:18:35 ET]
Table 'Donati' 6-max Seat #1 is the button
Seat 1: KRSofM ($4.94 in chips) 
Seat 2: FakaN4Kavera ($5.25 in chips) 
Seat 3: YAG5292 ($4.55 in chips) 
Seat 4: egoor199 ($4.48 in chips) 
Seat 5: kalopara ($18.48 in chips) 
Seat 6: delfinato200 ($13.95 in chips) 
FakaN4Kavera: posts small blind $0.02
YAG5292: posts big blind $0.05
*** HOLE CARDS ***
Dealt to FakaN4Kavera [Ks 8d]
egoor199: raises $0.05 to $0.10
kalopara: calls $0.10
delfinato200: folds 
KRSofM: folds 
FakaN4Kavera: folds 
YAG5292: calls $0.05
*** FLOP *** [Qd 9c 7s]
YAG5292: checks 
egoor199: checks 
kalopara: checks 
*** TURN *** [Qd 9c 7s] [6s]
YAG5292: bets $0.16
egoor199: folds 
kalopara: folds 
Uncalled bet ($0.16) returned to YAG5292
YAG5292 collected $0.31 from pot
YAG5292: doesn't show hand 
*** SUMMARY ***
Total pot $0.32 | Rake $0.01 
Board [Qd 9c 7s 6s]
Seat 1: KRSofM (button) folded before Flop (didn't bet)
Seat 2: FakaN4Kavera (small blind) folded before Flop
Seat 3: YAG5292 (big blind) collected ($0.31)
Seat 4: egoor199 folded on the Turn
Seat 5: kalopara folded on the Turn
Seat 6: delfinato200 folded before Flop (didn't bet)



PokerStars Zoom Hand #257879908224:  Hold'em No Limit ($0.02/$0.05) - 2025/09/25 19:19:05 JST [2025/09/25 6:19:05 ET]
Table 'Donati' 6-max Seat #1 is the button
Seat 1: YAG5292 ($4.76 in chips) 
Seat 2: Woidprophet ($6.51 in chips) 
Seat 3: intentii ($5.07 in chips) 
Seat 4: leakleakA ($9.04 in chips) 
Seat 5: faithfulness ($5.24 in chips) 
Seat 6: FakaN4Kavera ($5.25 in chips) 
Woidprophet: posts small blind $0.02
intentii: posts big blind $0.05
*** HOLE CARDS ***
Dealt to FakaN4Kavera [6s 3d]
leakleakA: folds 
faithfulness: folds 
FakaN4Kavera: folds 
YAG5292: folds 
Woidprophet: folds 
Uncalled bet ($0.03) returned to intentii
intentii collected $0.04 from pot
intentii: doesn't show hand 
*** SUMMARY ***
Total pot $0.04 | Rake $0 
Seat 1: YAG5292 (button) folded before Flop (didn't bet)
Seat 2: Woidprophet (small blind) folded before Flop
Seat 3: intentii (big blind) collected ($0.04)
Seat 4: leakleakA folded before Flop (didn't bet)
Seat 5: faithfulness folded before Flop (didn't bet)
Seat 6: FakaN4Kavera folded before Flop (didn't bet)



PokerStars Zoom Hand #257879908814:  Hold'em No Limit ($0.02/$0.05) - 2025/09/25 19:19:11 JST [2025/09/25 6:19:11 ET]
Table 'Donati' 6-max Seat #1 is the button
Seat 1: Woidprophet ($6.49 in chips) 
Seat 2: delfinato200 ($13.90 in chips) 
Seat 3: kmc4444 ($6.22 in chips) 
Seat 4: faithfulness ($5 in chips) 
Seat 5: FakaN4Kavera ($5.25 in chips) 
Seat 6: Kenzo2211 ($8.38 in chips) 
delfinato200: posts small blind $0.02
kmc4444: posts big blind $0.05
*** HOLE CARDS ***
Dealt to FakaN4Kavera [5d 6c]
faithfulness: folds 
FakaN4Kavera: folds 
Kenzo2211: folds 
Woidprophet: folds 
delfinato200: folds 
Uncalled bet ($0.03) returned to kmc4444
kmc4444 collected $0.04 from pot
kmc4444: doesn't show hand 
*** SUMMARY ***
Total pot $0.04 | Rake $0 
Seat 1: Woidprophet (button) folded before Flop (didn't bet)
Seat 2: delfinato200 (small blind) folded before Flop
Seat 3: kmc4444 (big blind) collected ($0.04)
Seat 4: faithfulness folded before Flop (didn't bet)
Seat 5: FakaN4Kavera folded before Flop (didn't bet)
Seat 6: Kenzo2211 folded before Flop (didn't bet)



PokerStars Zoom Hand #257879907740:  Hold'em No Limit ($0.02/$0.05) - 2025/09/25 19:19:00 JST [2025/09/25 6:19:00 ET]
Table 'Donati' 6-max Seat #1 is the button
Seat 1: zodapoker ($5.30 in chips) 
Seat 2: faithfulness ($5 in chips) 
Seat 3: kalopara ($18.38 in chips) 
Seat 4: FakaN4Kavera ($5.25 in chips) 
Seat 5: _jay_44_jas ($5.62 in chips) 
Seat 6: gio119 ($5 in chips) 
faithfulness: posts small blind $0.02
kalopara: posts big blind $0.05
*** HOLE CARDS ***
Dealt to FakaN4Kavera [4s 7d]
FakaN4Kavera: folds 
_jay_44_jas: folds 
gio119: folds 
zodapoker: folds 
faithfulness: raises $0.10 to $0.15
kalopara: folds 
Uncalled bet ($0.10) returned to faithfulness
faithfulness collected $0.10 from pot
faithfulness: doesn't show hand 
*** SUMMARY ***
Total pot $0.10 | Rake $0 
Seat 1: zodapoker (button) folded before Flop (didn't bet)
Seat 2: faithfulness (small blind) collected ($0.10)
Seat 3: kalopara (big blind) folded before Flop
Seat 4: FakaN4Kavera folded before Flop (didn't bet)
Seat 5: _jay_44_jas folded before Flop (didn't bet)
Seat 6: gio119 folded before Flop (didn't bet)



PokerStars Zoom Hand #257879909380:  Hold'em No Limit ($0.02/$0.05) - 2025/09/25 19:19:17 JST [2025/09/25 6:19:17 ET]
Table 'Donati' 6-max Seat #1 is the button
Seat 1: gio119 ($5.14 in chips) 
Seat 2: gm__701 ($5 in chips) 
Seat 3: FakaN4Kavera ($5.25 in chips) 
Seat 4: leakleakA ($8.97 in chips) 
Seat 5: hatater ($5.32 in chips) 
Seat 6: 1Kronos ($16.04 in chips) 
gm__701: posts small blind $0.02
FakaN4Kavera: posts big blind $0.05
*** HOLE CARDS ***
Dealt to FakaN4Kavera [5s 8c]
leakleakA: folds 
hatater: folds 
1Kronos: folds 
gio119: folds 
gm__701: raises $0.11 to $0.16
FakaN4Kavera: folds 
Uncalled bet ($0.11) returned to gm__701
gm__701 collected $0.10 from pot
gm__701: doesn't show hand 
*** SUMMARY ***
Total pot $0.10 | Rake $0 
Seat 1: gio119 (button) folded before Flop (didn't bet)
Seat 2: gm__701 (small blind) collected ($0.10)
Seat 3: FakaN4Kavera (big blind) folded before Flop
Seat 4: leakleakA folded before Flop (didn't bet)
Seat 5: hatater folded before Flop (didn't bet)
Seat 6: 1Kronos folded before Flop (didn't bet)



PokerStars Zoom Hand #257879911155:  Hold'em No Limit ($0.02/$0.05) - 2025/09/25 19:19:36 JST [2025/09/25 6:19:36 ET]
Table 'Donati' 6-max Seat #1 is the button
Seat 1: egoor199 ($5.89 in chips) 
Seat 2: lebifflemaster ($6.11 in chips) 
Seat 3: bigdaveys ($11.31 in chips) 
Seat 4: FakaN4Kavera ($5.20 in chips) 
Seat 5: faithfulness ($5 in chips) 
Seat 6: leakleakA ($8.95 in chips) 
lebifflemaster: posts small blind $0.02
bigdaveys: posts big blind $0.05
*** HOLE CARDS ***
Dealt to FakaN4Kavera [3c 5c]
FakaN4Kavera: folds 
faithfulness: folds 
leakleakA: folds 
egoor199: folds 
lebifflemaster: raises $0.10 to $0.15
bigdaveys: calls $0.10
*** FLOP *** [5h 7s Ad]
lebifflemaster: bets $0.10
bigdaveys: folds 
Uncalled bet ($0.10) returned to lebifflemaster
lebifflemaster collected $0.29 from pot
lebifflemaster: doesn't show hand 
*** SUMMARY ***
Total pot $0.30 | Rake $0.01 
Board [5h 7s Ad]
Seat 1: egoor199 (button) folded before Flop (didn't bet)
Seat 2: lebifflemaster (small blind) collected ($0.29)
Seat 3: bigdaveys (big blind) folded on the Flop
Seat 4: FakaN4Kavera folded before Flop (didn't bet)
Seat 5: faithfulness folded before Flop (didn't bet)
Seat 6: leakleakA folded before Flop (didn't bet)



PokerStars Zoom Hand #257879911725:  Hold'em No Limit ($0.02/$0.05) - 2025/09/25 19:19:42 JST [2025/09/25 6:19:42 ET]
Table 'Donati' 6-max Seat #1 is the button
Seat 1: egoor199 ($4.31 in chips) 
Seat 2: FakaN4Kavera ($5.20 in chips) 
Seat 3: faithfulness ($5.07 in chips) 
Seat 4: Woidprophet ($6.44 in chips) 
Seat 5: gio119 ($5.12 in chips) 
Seat 6: ElBrato421 ($4.55 in chips) 
FakaN4Kavera: posts small blind $0.02
faithfulness: posts big blind $0.05
*** HOLE CARDS ***
Dealt to FakaN4Kavera [3c 5d]
Woidprophet: folds 
gio119: folds 
ElBrato421: folds 
egoor199: raises $0.05 to $0.10
FakaN4Kavera: folds 
faithfulness: raises $0.40 to $0.50
egoor199: folds 
Uncalled bet ($0.40) returned to faithfulness
faithfulness collected $0.22 from pot
faithfulness: doesn't show hand 
*** SUMMARY ***
Total pot $0.22 | Rake $0 
Seat 1: egoor199 (button) folded before Flop
Seat 2: FakaN4Kavera (small blind) folded before Flop
Seat 3: faithfulness (big blind) collected ($0.22)
Seat 4: Woidprophet folded before Flop (didn't bet)
Seat 5: gio119 folded before Flop (didn't bet)
Seat 6: ElBrato421 folded before Flop (didn't bet)



PokerStars Zoom Hand #257879913340:  Hold'em No Limit ($0.02/$0.05) - 2025/09/25 19:20:00 JST [2025/09/25 6:20:00 ET]
Table 'Donati' 6-max Seat #1 is the button
Seat 1: FakaN4Kavera ($5.18 in chips) 
Seat 2: gm__701 ($5.57 in chips) 
Seat 3: Woidprophet ($6.31 in chips) 
Seat 4: kmc4444 ($6.22 in chips) 
Seat 5: kalopara ($18.38 in chips) 
Seat 6: gio119 ($5 in chips) 
gm__701: posts small blind $0.02
Woidprophet: posts big blind $0.05
*** HOLE CARDS ***
Dealt to FakaN4Kavera [6d 7s]
kmc4444: folds 
kalopara: folds 
gio119: folds 
FakaN4Kavera: raises $0.07 to $0.12
gm__701: folds 
Woidprophet: raises $0.27 to $0.39
FakaN4Kavera: folds 
Uncalled bet ($0.27) returned to Woidprophet
Woidprophet collected $0.26 from pot
Woidprophet: doesn't show hand 
*** SUMMARY ***
Total pot $0.26 | Rake $0 
Seat 1: FakaN4Kavera (button) folded before Flop
Seat 2: gm__701 (small blind) folded before Flop
Seat 3: Woidprophet (big blind) collected ($0.26)
Seat 4: kmc4444 folded before Flop (didn't bet)
Seat 5: kalopara folded before Flop (didn't bet)
Seat 6: gio119 folded before Flop (didn't bet)



PokerStars Zoom Hand #257879915129:  Hold'em No Limit ($0.02/$0.05) - 2025/09/25 19:20:19 JST [2025/09/25 6:20:19 ET]
Table 'Donati' 6-max Seat #1 is the button
Seat 1: egoor199 ($6.06 in chips) 
Seat 2: 1Kronos ($15.89 in chips) 
Seat 3: gm__701 ($5.55 in chips) 
Seat 4: huyjokezy ($5.29 in chips) 
Seat 5: zodapoker ($5.21 in chips) 
Seat 6: FakaN4Kavera ($5.06 in chips) 
1Kronos: posts small blind $0.02
gm__701: posts big blind $0.05
*** HOLE CARDS ***
Dealt to FakaN4Kavera [6h Tc]
huyjokezy: folds 
zodapoker: raises $0.07 to $0.12
FakaN4Kavera: folds 
egoor199: folds 
1Kronos: folds 
gm__701: folds 
Uncalled bet ($0.07) returned to zodapoker
zodapoker collected $0.12 from pot
zodapoker: doesn't show hand 
*** SUMMARY ***
Total pot $0.12 | Rake $0 
Seat 1: egoor199 (button) folded before Flop (didn't bet)
Seat 2: 1Kronos (small blind) folded before Flop
Seat 3: gm__701 (big blind) folded before Flop
Seat 4: huyjokezy folded before Flop (didn't bet)
Seat 5: zodapoker collected ($0.12)
Seat 6: FakaN4Kavera folded before Flop (didn't bet)



PokerStars Zoom Hand #257879910865:  Hold'em No Limit ($0.02/$0.05) - 2025/09/25 19:19:33 JST [2025/09/25 6:19:33 ET]
Table 'Donati' 6-max Seat #1 is the button
Seat 1: leakleakA ($8.95 in chips) 
Seat 2: Woidprophet ($7.95 in chips) 
Seat 3: delfinato200 ($13.88 in chips) 
Seat 4: 1Kronos ($10.04 in chips) 
Seat 5: FakaN4Kavera ($5.20 in chips) 
Seat 6: gm__701 ($5.05 in chips) 
Woidprophet: posts small blind $0.02
delfinato200: posts big blind $0.05
*** HOLE CARDS ***
Dealt to FakaN4Kavera [5h 2s]
1Kronos: raises $0.07 to $0.12
FakaN4Kavera: folds 
gm__701: folds 
leakleakA: folds 
Woidprophet: calls $0.10
delfinato200: folds 
*** FLOP *** [Qh 5s 2c]
Woidprophet: checks 
1Kronos: checks 
*** TURN *** [Qh 5s 2c] [8c]
Woidprophet: checks 
1Kronos: bets $0.09
Woidprophet: calls $0.09
*** RIVER *** [Qh 5s 2c 8c] [Kc]
Woidprophet: checks 
1Kronos: checks 
*** SHOW DOWN ***
Woidprophet: shows [6s 7s] (high card King)
1Kronos: shows [9h 8h] (a pair of Eights)
1Kronos collected $0.45 from pot
*** SUMMARY ***
Total pot $0.47 | Rake $0.02 
Board [Qh 5s 2c 8c Kc]
Seat 1: leakleakA (button) folded before Flop (didn't bet)
Seat 2: Woidprophet (small blind) showed [6s 7s] and lost with high card King
Seat 3: delfinato200 (big blind) folded before Flop
Seat 4: 1Kronos showed [9h 8h] and won ($0.45) with a pair of Eights
Seat 5: FakaN4Kavera folded before Flop (didn't bet)
Seat 6: gm__701 folded before Flop (didn't bet)



PokerStars Zoom Hand #257879915468:  Hold'em No Limit ($0.02/$0.05) - 2025/09/25 19:20:23 JST [2025/09/25 6:20:23 ET]
Table 'Donati' 6-max Seat #1 is the button
Seat 1: VXNX$157 ($4.25 in chips) 
Seat 2: sk1bbz ($5 in chips) 
Seat 3: huyjokezy ($5.29 in chips) 
Seat 4: FakaN4Kavera ($5.06 in chips) 
Seat 5: intentii ($5.33 in chips) 
Seat 6: gio119 ($5 in chips) 
sk1bbz: posts small blind $0.02
huyjokezy: posts big blind $0.05
*** HOLE CARDS ***
Dealt to FakaN4Kavera [9d 9c]
FakaN4Kavera: raises $0.07 to $0.12
intentii: folds 
gio119: folds 
VXNX$157: folds 
sk1bbz: folds 
huyjokezy: calls $0.07
*** FLOP *** [3h 6s Ad]
huyjokezy: checks 
FakaN4Kavera: checks 
*** TURN *** [3h 6s Ad] [6c]
huyjokezy: checks 
FakaN4Kavera: checks 
*** RIVER *** [3h 6s Ad 6c] [7d]
huyjokezy: checks 
FakaN4Kavera: checks 
*** SHOW DOWN ***
huyjokezy: shows [Tc 8c] (a pair of Sixes)
FakaN4Kavera: shows [9d 9c] (two pair, Nines and Sixes)
FakaN4Kavera collected $0.25 from pot
*** SUMMARY ***
Total pot $0.26 | Rake $0.01 
Board [3h 6s Ad 6c 7d]
Seat 1: VXNX$157 (button) folded before Flop (didn't bet)
Seat 2: sk1bbz (small blind) folded before Flop
Seat 3: huyjokezy (big blind) showed [Tc 8c] and lost with a pair of Sixes
Seat 4: FakaN4Kavera showed [9d 9c] and won ($0.25) with two pair, Nines and Sixes
Seat 5: intentii folded before Flop (didn't bet)
Seat 6: gio119 folded before Flop (didn't bet)



PokerStars Zoom Hand #257879918259:  Hold'em No Limit ($0.02/$0.05) - 2025/09/25 19:20:53 JST [2025/09/25 6:20:53 ET]
Table 'Donati' 6-max Seat #1 is the button
Seat 1: kalopara ($29.32 in chips) 
Seat 2: huyjokezy ($5.17 in chips) 
Seat 3: Baikasas ($5 in chips) 
Seat 4: 1Kronos ($10.26 in chips) 
Seat 5: FakaN4Kavera ($5.19 in chips) 
Seat 6: gio119 ($5 in chips) 
huyjokezy: posts small blind $0.02
Baikasas: posts big blind $0.05
*** HOLE CARDS ***
Dealt to FakaN4Kavera [5h 9d]
1Kronos: folds 
FakaN4Kavera: folds 
gio119: calls $0.05
kalopara: raises $0.15 to $0.20
huyjokezy: folds 
Baikasas: folds 
gio119: folds 
Uncalled bet ($0.15) returned to kalopara
kalopara collected $0.17 from pot
kalopara: doesn't show hand 
*** SUMMARY ***
Total pot $0.17 | Rake $0 
Seat 1: kalopara (button) collected ($0.17)
Seat 2: huyjokezy (small blind) folded before Flop
Seat 3: Baikasas (big blind) folded before Flop
Seat 4: 1Kronos folded before Flop (didn't bet)
Seat 5: FakaN4Kavera folded before Flop (didn't bet)
Seat 6: gio119 folded before Flop



PokerStars Zoom Hand #257879918892:  Hold'em No Limit ($0.02/$0.05) - 2025/09/25 19:21:00 JST [2025/09/25 6:21:00 ET]
Table 'Donati' 6-max Seat #1 is the button
Seat 1: VXNX$157 ($4.30 in chips) 
Seat 2: leakleakA ($8.83 in chips) 
Seat 3: FakaN4Kavera ($5.19 in chips) 
Seat 4: gio119 ($5 in chips) 
Seat 5: hatater ($6.59 in chips) 
Seat 6: kmc4444 ($6.55 in chips) 
leakleakA: posts small blind $0.02
FakaN4Kavera: posts big blind $0.05
*** HOLE CARDS ***
Dealt to FakaN4Kavera [4h 6h]
gio119: folds 
hatater: folds 
kmc4444: folds 
VXNX$157: raises $0.07 to $0.12
leakleakA: raises $0.40 to $0.52
FakaN4Kavera: folds 
VXNX$157: folds 
Uncalled bet ($0.40) returned to leakleakA
leakleakA collected $0.29 from pot
leakleakA: doesn't show hand 
*** SUMMARY ***
Total pot $0.29 | Rake $0 
Seat 1: VXNX$157 (button) folded before Flop
Seat 2: leakleakA (small blind) collected ($0.29)
Seat 3: FakaN4Kavera (big blind) folded before Flop
Seat 4: gio119 folded before Flop (didn't bet)
Seat 5: hatater folded before Flop (didn't bet)
Seat 6: kmc4444 folded before Flop (didn't bet)



PokerStars Zoom Hand #257879921504:  Hold'em No Limit ($0.02/$0.05) - 2025/09/25 19:21:28 JST [2025/09/25 6:21:28 ET]
Table 'Donati' 6-max Seat #1 is the button
Seat 1: FakaN4Kavera ($5.12 in chips) 
Seat 2: gm__701 ($5.38 in chips) 
Seat 3: egoor199 ($4.14 in chips) 
Seat 4: kmc4444 ($6.53 in chips) 
Seat 5: huyjokezy ($5.09 in chips) 
Seat 6: 1Kronos ($10.12 in chips) 
gm__701: posts small blind $0.02
egoor199: posts big blind $0.05
*** HOLE CARDS ***
Dealt to FakaN4Kavera [9d Ks]
kmc4444: raises $0.05 to $0.10
huyjokezy: folds 
1Kronos: folds 
FakaN4Kavera: folds 
gm__701: folds 
egoor199: folds 
Uncalled bet ($0.05) returned to kmc4444
kmc4444 collected $0.12 from pot
kmc4444: doesn't show hand 
*** SUMMARY ***
Total pot $0.12 | Rake $0 
Seat 1: FakaN4Kavera (button) folded before Flop (didn't bet)
Seat 2: gm__701 (small blind) folded before Flop
Seat 3: egoor199 (big blind) folded before Flop
Seat 4: kmc4444 collected ($0.12)
Seat 5: huyjokezy folded before Flop (didn't bet)
Seat 6: 1Kronos folded before Flop (didn't bet)



PokerStars Zoom Hand #257879920391:  Hold'em No Limit ($0.02/$0.05) - 2025/09/25 19:21:16 JST [2025/09/25 6:21:16 ET]
Table 'Donati' 6-max Seat #1 is the button
Seat 1: yuri.pohr ($5.12 in chips) 
Seat 2: FakaN4Kavera ($5.14 in chips) 
Seat 3: Woidprophet ($5.23 in chips) 
Seat 4: Vasco4430 ($6.13 in chips) 
Seat 5: lebifflemaster ($9.58 in chips) 
Seat 6: Ingyeoking ($3.63 in chips) 
FakaN4Kavera: posts small blind $0.02
Woidprophet: posts big blind $0.05
*** HOLE CARDS ***
Dealt to FakaN4Kavera [Ts Kd]
Vasco4430: folds 
lebifflemaster: folds 
Ingyeoking: folds 
yuri.pohr: raises $0.10 to $0.15
FakaN4Kavera: folds 
Woidprophet: folds 
Uncalled bet ($0.10) returned to yuri.pohr
yuri.pohr collected $0.12 from pot
yuri.pohr: doesn't show hand 
*** SUMMARY ***
Total pot $0.12 | Rake $0 
Seat 1: yuri.pohr (button) collected ($0.12)
Seat 2: FakaN4Kavera (small blind) folded before Flop
Seat 3: Woidprophet (big blind) folded before Flop
Seat 4: Vasco4430 folded before Flop (didn't bet)
Seat 5: lebifflemaster folded before Flop (didn't bet)
Seat 6: Ingyeoking folded before Flop (didn't bet)



PokerStars Zoom Hand #257879923105:  Hold'em No Limit ($0.02/$0.05) - 2025/09/25 19:21:45 JST [2025/09/25 6:21:45 ET]
Table 'Donati' 6-max Seat #1 is the button
Seat 1: Ingyeoking ($3.61 in chips) 
Seat 2: FakaN4Kavera ($5.12 in chips) 
Seat 3: delfinato200 ($14.42 in chips) 
Seat 4: huyjokezy ($5.07 in chips) 
Seat 5: gio119 ($5 in chips) 
Seat 6: scottie4barnes ($4.78 in chips) 
FakaN4Kavera: posts small blind $0.02
delfinato200: posts big blind $0.05
*** HOLE CARDS ***
Dealt to FakaN4Kavera [2d 9d]
huyjokezy: folds 
gio119: folds 
scottie4barnes: folds 
Ingyeoking: raises $0.07 to $0.12
FakaN4Kavera: folds 
delfinato200: folds 
Uncalled bet ($0.07) returned to Ingyeoking
Ingyeoking collected $0.12 from pot
Ingyeoking: doesn't show hand 
*** SUMMARY ***
Total pot $0.12 | Rake $0 
Seat 1: Ingyeoking (button) collected ($0.12)
Seat 2: FakaN4Kavera (small blind) folded before Flop
Seat 3: delfinato200 (big blind) folded before Flop
Seat 4: huyjokezy folded before Flop (didn't bet)
Seat 5: gio119 folded before Flop (didn't bet)
Seat 6: scottie4barnes folded before Flop (didn't bet)



PokerStars Zoom Hand #257879923377:  Hold'em No Limit ($0.02/$0.05) - 2025/09/25 19:21:48 JST [2025/09/25 6:21:48 ET]
Table 'Donati' 6-max Seat #1 is the button
Seat 1: gm__701 ($5 in chips) 
Seat 2: koshchey_a ($9.81 in chips) 
Seat 3: FakaN4Kavera ($5.10 in chips) 
Seat 4: gio119 ($5 in chips) 
Seat 5: Woidprophet ($7.23 in chips) 
Seat 6: yuri.pohr ($5.19 in chips) 
koshchey_a: posts small blind $0.02
FakaN4Kavera: posts big blind $0.05
*** HOLE CARDS ***
Dealt to FakaN4Kavera [4h 7s]
gio119: folds 
Woidprophet: folds 
yuri.pohr: folds 
gm__701: raises $0.09 to $0.14
koshchey_a: folds 
FakaN4Kavera: folds 
Uncalled bet ($0.09) returned to gm__701
gm__701 collected $0.12 from pot
gm__701: doesn't show hand 
*** SUMMARY ***
Total pot $0.12 | Rake $0 
Seat 1: gm__701 (button) collected ($0.12)
Seat 2: koshchey_a (small blind) folded before Flop
Seat 3: FakaN4Kavera (big blind) folded before Flop
Seat 4: gio119 folded before Flop (didn't bet)
Seat 5: Woidprophet folded before Flop (didn't bet)
Seat 6: yuri.pohr folded before Flop (didn't bet)



PokerStars Zoom Hand #257879922629:  Hold'em No Limit ($0.02/$0.05) - 2025/09/25 19:21:40 JST [2025/09/25 6:21:40 ET]
Table 'Donati' 6-max Seat #1 is the button
Seat 1: delfinato200 ($14.42 in chips) 
Seat 2: intentii ($5.09 in chips) 
Seat 3: zodapoker ($5.69 in chips) 
Seat 4: gm__701 ($5.36 in chips) 
Seat 5: Ingyeoking ($3.61 in chips) 
Seat 6: FakaN4Kavera ($5.12 in chips) 
intentii: posts small blind $0.02
zodapoker: posts big blind $0.05
*** HOLE CARDS ***
Dealt to FakaN4Kavera [5c Th]
gm__701: folds 
Ingyeoking: folds 
FakaN4Kavera: folds 
delfinato200: folds 
intentii: raises $0.10 to $0.15
zodapoker: calls $0.10
*** FLOP *** [Td Jd 5h]
intentii: checks 
zodapoker: checks 
*** TURN *** [Td Jd 5h] [Ts]
intentii: bets $0.22
zodapoker: folds 
Uncalled bet ($0.22) returned to intentii
intentii collected $0.29 from pot
intentii: doesn't show hand 
*** SUMMARY ***
Total pot $0.30 | Rake $0.01 
Board [Td Jd 5h Ts]
Seat 1: delfinato200 (button) folded before Flop (didn't bet)
Seat 2: intentii (small blind) collected ($0.29)
Seat 3: zodapoker (big blind) folded on the Turn
Seat 4: gm__701 folded before Flop (didn't bet)
Seat 5: Ingyeoking folded before Flop (didn't bet)
Seat 6: FakaN4Kavera folded before Flop (didn't bet)



PokerStars Zoom Hand #257879922144:  Hold'em No Limit ($0.02/$0.05) - 2025/09/25 19:21:35 JST [2025/09/25 6:21:35 ET]
Table 'Donati' 6-max Seat #1 is the button
Seat 1: egoor199 ($6.23 in chips) 
Seat 2: BretticusX ($6.25 in chips) 
Seat 3: Baikasas ($5.01 in chips) 
Seat 4: FakaN4Kavera ($5.12 in chips) 
Seat 5: gm__701 ($5.36 in chips) 
Seat 6: kmc4444 ($5.20 in chips) 
BretticusX: posts small blind $0.02
Baikasas: posts big blind $0.05
*** HOLE CARDS ***
Dealt to FakaN4Kavera [6h 8s]
FakaN4Kavera: folds 
gm__701: folds 
kmc4444: raises $0.07 to $0.12
egoor199: folds 
BretticusX: folds 
Baikasas: calls $0.07
*** FLOP *** [7c 3d Jd]
Baikasas: checks 
kmc4444: bets $0.08
Baikasas: calls $0.08
*** TURN *** [7c 3d Jd] [4d]
Baikasas: checks 
kmc4444: checks 
*** RIVER *** [7c 3d Jd 4d] [Js]
Baikasas: checks 
kmc4444: checks 
*** SHOW DOWN ***
Baikasas: shows [Tc Ac] (a pair of Jacks)
kmc4444: shows [9h 7h] (two pair, Jacks and Sevens)
kmc4444 collected $0.40 from pot
*** SUMMARY ***
Total pot $0.42 | Rake $0.02 
Board [7c 3d Jd 4d Js]
Seat 1: egoor199 (button) folded before Flop (didn't bet)
Seat 2: BretticusX (small blind) folded before Flop
Seat 3: Baikasas (big blind) showed [Tc Ac] and lost with a pair of Jacks
Seat 4: FakaN4Kavera folded before Flop (didn't bet)
Seat 5: gm__701 folded before Flop (didn't bet)
Seat 6: kmc4444 showed [9h 7h] and won ($0.40) with two pair, Jacks and Sevens



PokerStars Zoom Hand #257879924023:  Hold'em No Limit ($0.02/$0.05) - 2025/09/25 19:21:55 JST [2025/09/25 6:21:55 ET]
Table 'Donati' 6-max Seat #1 is the button
Seat 1: gio119 ($5.46 in chips) 
Seat 2: Woidprophet ($5.18 in chips) 
Seat 3: huyjokezy ($5.15 in chips) 
Seat 4: KRSofM ($4.99 in chips) 
Seat 5: FakaN4Kavera ($5.05 in chips) 
Seat 6: YAG5292 ($7.81 in chips) 
Woidprophet: posts small blind $0.02
huyjokezy: posts big blind $0.05
*** HOLE CARDS ***
Dealt to FakaN4Kavera [Js Ks]
KRSofM: folds 
FakaN4Kavera: raises $0.07 to $0.12
YAG5292: calls $0.12
gio119: folds 
Woidprophet: folds 
huyjokezy: calls $0.07
*** FLOP *** [Qh Jc 4h]
huyjokezy: checks 
FakaN4Kavera: checks 
YAG5292: checks 
*** TURN *** [Qh Jc 4h] [7s]
huyjokezy: checks 
FakaN4Kavera: checks 
YAG5292: checks 
*** RIVER *** [Qh Jc 4h 7s] [8h]
huyjokezy: checks 
FakaN4Kavera: checks 
YAG5292: checks 
*** SHOW DOWN ***
huyjokezy: shows [4d 6d] (a pair of Fours)
FakaN4Kavera: shows [Js Ks] (a pair of Jacks)
YAG5292: mucks hand 
FakaN4Kavera collected $0.36 from pot
*** SUMMARY ***
Total pot $0.38 | Rake $0.02 
Board [Qh Jc 4h 7s 8h]
Seat 1: gio119 (button) folded before Flop (didn't bet)
Seat 2: Woidprophet (small blind) folded before Flop
Seat 3: huyjokezy (big blind) showed [4d 6d] and lost with a pair of Fours
Seat 4: KRSofM folded before Flop (didn't bet)
Seat 5: FakaN4Kavera showed [Js Ks] and won ($0.36) with a pair of Jacks
Seat 6: YAG5292 mucked [6s 6c]



PokerStars Zoom Hand #257879929807:  Hold'em No Limit ($0.02/$0.05) - 2025/09/25 19:22:58 JST [2025/09/25 6:22:58 ET]
Table 'Donati' 6-max Seat #1 is the button
Seat 1: FakaN4Kavera ($5.29 in chips) 
Seat 2: Woidprophet ($5.25 in chips) 
Seat 3: gio119 ($5.39 in chips) 
Seat 4: huyjokezy ($5.03 in chips) 
Seat 5: YAG5292 ($7.69 in chips) 
Seat 6: Kenzo2211 ($8.59 in chips) 
Woidprophet: posts small blind $0.02
gio119: posts big blind $0.05
*** HOLE CARDS ***
Dealt to FakaN4Kavera [Qd Kh]
huyjokezy: raises $0.10 to $0.15
YAG5292: folds 
Kenzo2211: folds 
FakaN4Kavera: calls $0.15
Woidprophet: folds 
gio119: folds 
*** FLOP *** [2h 8c 4d]
huyjokezy: bets $0.18
FakaN4Kavera: folds 
Uncalled bet ($0.18) returned to huyjokezy
huyjokezy collected $0.35 from pot
huyjokezy: doesn't show hand 
*** SUMMARY ***
Total pot $0.37 | Rake $0.02 
Board [2h 8c 4d]
Seat 1: FakaN4Kavera (button) folded on the Flop
Seat 2: Woidprophet (small blind) folded before Flop
Seat 3: gio119 (big blind) folded before Flop
Seat 4: huyjokezy collected ($0.35)
Seat 5: YAG5292 folded before Flop (didn't bet)
Seat 6: Kenzo2211 folded before Flop (didn't bet)



PokerStars Zoom Hand #257879931766:  Hold'em No Limit ($0.02/$0.05) - 2025/09/25 19:23:19 JST [2025/09/25 6:23:19 ET]
Table 'Donati' 6-max Seat #1 is the button
Seat 1: Woidprophet ($6.40 in chips) 
Seat 2: gio119 ($5 in chips) 
Seat 3: egoor199 ($6.16 in chips) 
Seat 4: KRSofM ($6.73 in chips) 
Seat 5: BrickByBrick68 ($18.59 in chips) 
Seat 6: FakaN4Kavera ($5.14 in chips) 
gio119: posts small blind $0.02
egoor199: posts big blind $0.05
*** HOLE CARDS ***
Dealt to FakaN4Kavera [Ac 7h]
KRSofM: raises $0.05 to $0.10
BrickByBrick68: folds 
FakaN4Kavera: folds 
Woidprophet: folds 
gio119: folds 
egoor199: folds 
Uncalled bet ($0.05) returned to KRSofM
KRSofM collected $0.12 from pot
KRSofM: doesn't show hand 
*** SUMMARY ***
Total pot $0.12 | Rake $0 
Seat 1: Woidprophet (button) folded before Flop (didn't bet)
Seat 2: gio119 (small blind) folded before Flop
Seat 3: egoor199 (big blind) folded before Flop
Seat 4: KRSofM collected ($0.12)
Seat 5: BrickByBrick68 folded before Flop (didn't bet)
Seat 6: FakaN4Kavera folded before Flop (didn't bet)



PokerStars Zoom Hand #257879933466:  Hold'em No Limit ($0.02/$0.05) - 2025/09/25 19:23:37 JST [2025/09/25 6:23:37 ET]
Table 'Donati' 6-max Seat #1 is the button
Seat 1: intentii ($6.37 in chips) 
Seat 2: FakaN4Kavera ($5.14 in chips) 
Seat 3: Epist461 ($5 in chips) 
Seat 4: zodapoker ($7.19 in chips) 
Seat 5: elmex886 ($5.12 in chips) 
Seat 6: kmc4444 ($6.67 in chips) 
FakaN4Kavera: posts small blind $0.02
Epist461: posts big blind $0.05
*** HOLE CARDS ***
Dealt to FakaN4Kavera [9s Tc]
zodapoker: raises $0.07 to $0.12
elmex886: folds 
kmc4444: folds 
intentii: folds 
FakaN4Kavera: folds 
Epist461: raises $0.48 to $0.60
zodapoker: folds 
Uncalled bet ($0.48) returned to Epist461
Epist461 collected $0.26 from pot
Epist461: doesn't show hand 
*** SUMMARY ***
Total pot $0.26 | Rake $0 
Seat 1: intentii (button) folded before Flop (didn't bet)
Seat 2: FakaN4Kavera (small blind) folded before Flop
Seat 3: Epist461 (big blind) collected ($0.26)
Seat 4: zodapoker folded before Flop
Seat 5: elmex886 folded before Flop (didn't bet)
Seat 6: kmc4444 folded before Flop (didn't bet)



PokerStars Zoom Hand #257879934144:  Hold'em No Limit ($0.02/$0.05) - 2025/09/25 19:23:44 JST [2025/09/25 6:23:44 ET]
Table 'Donati' 6-max Seat #1 is the button
Seat 1: snake oil 12 ($5.06 in chips) 
Seat 2: kmc4444 ($6.67 in chips) 
Seat 3: FakaN4Kavera ($5.12 in chips) 
Seat 4: gio119 ($5 in chips) 
Seat 5: goaßmaß-fips ($6.78 in chips) 
Seat 6: huyjokezy ($5 in chips) 
kmc4444: posts small blind $0.02
FakaN4Kavera: posts big blind $0.05
*** HOLE CARDS ***
Dealt to FakaN4Kavera [6h Td]
gio119: folds 
goaßmaß-fips: folds 
huyjokezy: folds 
snake oil 12: raises $0.05 to $0.10
kmc4444: folds 
FakaN4Kavera: folds 
Uncalled bet ($0.05) returned to snake oil 12
snake oil 12 collected $0.12 from pot
snake oil 12: doesn't show hand 
*** SUMMARY ***
Total pot $0.12 | Rake $0 
Seat 1: snake oil 12 (button) collected ($0.12)
Seat 2: kmc4444 (small blind) folded before Flop
Seat 3: FakaN4Kavera (big blind) folded before Flop
Seat 4: gio119 folded before Flop (didn't bet)
Seat 5: goaßmaß-fips folded before Flop (didn't bet)
Seat 6: huyjokezy folded before Flop (didn't bet)



PokerStars Zoom Hand #257879936380:  Hold'em No Limit ($0.02/$0.05) - 2025/09/25 19:24:08 JST [2025/09/25 6:24:08 ET]
Table 'Donati' 6-max Seat #1 is the button
Seat 1: Epist461 ($5.12 in chips) 
Seat 2: zodapoker ($4.66 in chips) 
Seat 3: Ingyeoking ($3.61 in chips) 
Seat 4: FakaN4Kavera ($5.07 in chips) 
Seat 5: Irrubikajs ($2.50 in chips) 
Seat 6: Choi Moneky ($5.18 in chips) 
zodapoker: posts small blind $0.02
Ingyeoking: posts big blind $0.05
*** HOLE CARDS ***
Dealt to FakaN4Kavera [8d Ac]
FakaN4Kavera: folds 
Irrubikajs: folds 
Choi Moneky: folds 
Epist461: folds 
zodapoker: folds 
Uncalled bet ($0.03) returned to Ingyeoking
Ingyeoking collected $0.04 from pot
Ingyeoking: doesn't show hand 
*** SUMMARY ***
Total pot $0.04 | Rake $0 
Seat 1: Epist461 (button) folded before Flop (didn't bet)
Seat 2: zodapoker (small blind) folded before Flop
Seat 3: Ingyeoking (big blind) collected ($0.04)
Seat 4: FakaN4Kavera folded before Flop (didn't bet)
Seat 5: Irrubikajs folded before Flop (didn't bet)
Seat 6: Choi Moneky folded before Flop (didn't bet)



PokerStars Zoom Hand #257879933007:  Hold'em No Limit ($0.02/$0.05) - 2025/09/25 19:23:32 JST [2025/09/25 6:23:32 ET]
Table 'Donati' 6-max Seat #1 is the button
Seat 1: serg430606 ($5.21 in chips) 
Seat 2: gena60 ($12.54 in chips) 
Seat 3: pink bull 78 ($3.05 in chips) 
Seat 4: FakaN4Kavera ($5.14 in chips) 
Seat 5: snake oil 12 ($5.06 in chips) 
Seat 6: gio119 ($5.32 in chips) 
gena60: posts small blind $0.02
pink bull 78: posts big blind $0.05
*** HOLE CARDS ***
Dealt to FakaN4Kavera [Kc 7s]
FakaN4Kavera: folds 
snake oil 12: folds 
gio119: calls $0.05
serg430606: calls $0.05
gena60: folds 
pink bull 78: checks 
*** FLOP *** [7d 6h 4d]
pink bull 78: checks 
gio119: bets $0.16
serg430606: folds 
pink bull 78: folds 
Uncalled bet ($0.16) returned to gio119
gio119 collected $0.16 from pot
gio119: doesn't show hand 
*** SUMMARY ***
Total pot $0.17 | Rake $0.01 
Board [7d 6h 4d]
Seat 1: serg430606 (button) folded on the Flop
Seat 2: gena60 (small blind) folded before Flop
Seat 3: pink bull 78 (big blind) folded on the Flop
Seat 4: FakaN4Kavera folded before Flop (didn't bet)
Seat 5: snake oil 12 folded before Flop (didn't bet)
Seat 6: gio119 collected ($0.16)



PokerStars Zoom Hand #257879937178:  Hold'em No Limit ($0.02/$0.05) - 2025/09/25 19:24:16 JST [2025/09/25 6:24:16 ET]
Table 'Donati' 6-max Seat #1 is the button
Seat 1: FakaN4Kavera ($5.07 in chips) 
Seat 2: egoor199 ($3.80 in chips) 
Seat 3: gio119 ($5 in chips) 
Seat 4: Woidprophet ($5.06 in chips) 
Seat 5: zodapoker ($5.60 in chips) 
Seat 6: huyjokezy ($5.01 in chips) 
egoor199: posts small blind $0.02
gio119: posts big blind $0.05
*** HOLE CARDS ***
Dealt to FakaN4Kavera [Kd 4c]
Woidprophet: folds 
zodapoker: raises $0.07 to $0.12
huyjokezy: folds 
FakaN4Kavera: folds 
egoor199: folds 
gio119: folds 
Uncalled bet ($0.07) returned to zodapoker
zodapoker collected $0.12 from pot
zodapoker: doesn't show hand 
*** SUMMARY ***
Total pot $0.12 | Rake $0 
Seat 1: FakaN4Kavera (button) folded before Flop (didn't bet)
Seat 2: egoor199 (small blind) folded before Flop
Seat 3: gio119 (big blind) folded before Flop
Seat 4: Woidprophet folded before Flop (didn't bet)
Seat 5: zodapoker collected ($0.12)
Seat 6: huyjokezy folded before Flop (didn't bet)



PokerStars Zoom Hand #257879938702:  Hold'em No Limit ($0.02/$0.05) - 2025/09/25 19:24:32 JST [2025/09/25 6:24:32 ET]
Table 'Donati' 6-max Seat #1 is the button
Seat 1: Ingyeoking ($5.92 in chips) 
Seat 2: Epist461 ($5.29 in chips) 
Seat 3: kmc4444 ($5 in chips) 
Seat 4: FakaN4Kavera ($5.07 in chips) 
Seat 5: snake oil 12 ($5.08 in chips) 
Seat 6: huyjokezy ($5.01 in chips) 
Epist461: posts small blind $0.02
kmc4444: posts big blind $0.05
*** HOLE CARDS ***
Dealt to FakaN4Kavera [4h 6d]
FakaN4Kavera: folds 
snake oil 12: folds 
huyjokezy: folds 
Ingyeoking: folds 
Epist461: folds 
Uncalled bet ($0.03) returned to kmc4444
kmc4444 collected $0.04 from pot
kmc4444: doesn't show hand 
*** SUMMARY ***
Total pot $0.04 | Rake $0 
Seat 1: Ingyeoking (button) folded before Flop (didn't bet)
Seat 2: Epist461 (small blind) folded before Flop
Seat 3: kmc4444 (big blind) collected ($0.04)
Seat 4: FakaN4Kavera folded before Flop (didn't bet)
Seat 5: snake oil 12 folded before Flop (didn't bet)
Seat 6: huyjokezy folded before Flop (didn't bet)



PokerStars Zoom Hand #257879937557:  Hold'em No Limit ($0.02/$0.05) - 2025/09/25 19:24:20 JST [2025/09/25 6:24:20 ET]
Table 'Donati' 6-max Seat #1 is the button
Seat 1: BretticusX ($5.97 in chips) 
Seat 2: Irrubikajs ($3.32 in chips) 
Seat 3: Vasco4430 ($7.63 in chips) 
Seat 4: Kenzo2211 ($5 in chips) 
Seat 5: FakaN4Kavera ($5.07 in chips) 
Seat 6: kmc4444 ($5 in chips) 
Irrubikajs: posts small blind $0.02
Vasco4430: posts big blind $0.05
*** HOLE CARDS ***
Dealt to FakaN4Kavera [4s 3h]
Kenzo2211: raises $0.05 to $0.10
FakaN4Kavera: folds 
kmc4444: folds 
BretticusX: folds 
Irrubikajs: calls $0.08
Vasco4430: calls $0.05
*** FLOP *** [Js 2c 3d]
Irrubikajs: checks 
Vasco4430: bets $0.15
Kenzo2211: folds 
Irrubikajs: folds 
Uncalled bet ($0.15) returned to Vasco4430
Vasco4430 collected $0.29 from pot
Vasco4430: doesn't show hand 
*** SUMMARY ***
Total pot $0.30 | Rake $0.01 
Board [Js 2c 3d]
Seat 1: BretticusX (button) folded before Flop (didn't bet)
Seat 2: Irrubikajs (small blind) folded on the Flop
Seat 3: Vasco4430 (big blind) collected ($0.29)
Seat 4: Kenzo2211 folded on the Flop
Seat 5: FakaN4Kavera folded before Flop (didn't bet)
Seat 6: kmc4444 folded before Flop (didn't bet)



PokerStars Zoom Hand #257879938310:  Hold'em No Limit ($0.02/$0.05) - 2025/09/25 19:24:28 JST [2025/09/25 6:24:28 ET]
Table 'Donati' 6-max Seat #1 is the button
Seat 1: Woidprophet ($6.26 in chips) 
Seat 2: YAG5292 ($8.69 in chips) 
Seat 3: Irrubikajs ($2.50 in chips) 
Seat 4: zodapoker ($4.64 in chips) 
Seat 5: lebifflemaster ($8.95 in chips) 
Seat 6: FakaN4Kavera ($5.07 in chips) 
YAG5292: posts small blind $0.02
Irrubikajs: posts big blind $0.05
*** HOLE CARDS ***
Dealt to FakaN4Kavera [2c Kh]
zodapoker: folds 
lebifflemaster: folds 
FakaN4Kavera: folds 
Woidprophet: raises $0.10 to $0.15
YAG5292: folds 
Irrubikajs: raises $0.45 to $0.60
Woidprophet: folds 
Uncalled bet ($0.45) returned to Irrubikajs
Irrubikajs collected $0.32 from pot
Irrubikajs: doesn't show hand 
*** SUMMARY ***
Total pot $0.32 | Rake $0 
Seat 1: Woidprophet (button) folded before Flop
Seat 2: YAG5292 (small blind) folded before Flop
Seat 3: Irrubikajs (big blind) collected ($0.32)
Seat 4: zodapoker folded before Flop (didn't bet)
Seat 5: lebifflemaster folded before Flop (didn't bet)
Seat 6: FakaN4Kavera folded before Flop (didn't bet)



PokerStars Zoom Hand #257879939095:  Hold'em No Limit ($0.02/$0.05) - 2025/09/25 19:24:36 JST [2025/09/25 6:24:36 ET]
Table 'Donati' 6-max Seat #1 is the button
Seat 1: alpaz01 ($4.93 in chips) 
Seat 2: snake oil 12 ($5.08 in chips) 
Seat 3: FakaN4Kavera ($5.07 in chips) 
Seat 4: alexnffc1 ($1.99 in chips) 
Seat 5: egoor199 ($6.11 in chips) 
Seat 6: elmex886 ($5.12 in chips) 
snake oil 12: posts small blind $0.02
FakaN4Kavera: posts big blind $0.05
*** HOLE CARDS ***
Dealt to FakaN4Kavera [7d 8d]
alexnffc1: folds 
egoor199: folds 
elmex886: folds 
alpaz01: raises $0.10 to $0.15
snake oil 12: calls $0.13
FakaN4Kavera: calls $0.10
*** FLOP *** [Jh 4c Kh]
snake oil 12: bets $0.22
FakaN4Kavera: folds 
alpaz01: folds 
Uncalled bet ($0.22) returned to snake oil 12
snake oil 12 collected $0.43 from pot
snake oil 12: doesn't show hand 
*** SUMMARY ***
Total pot $0.45 | Rake $0.02 
Board [Jh 4c Kh]
Seat 1: alpaz01 (button) folded on the Flop
Seat 2: snake oil 12 (small blind) collected ($0.43)
Seat 3: FakaN4Kavera (big blind) folded on the Flop
Seat 4: alexnffc1 folded before Flop (didn't bet)
Seat 5: egoor199 folded before Flop (didn't bet)
Seat 6: elmex886 folded before Flop (didn't bet)



PokerStars Zoom Hand #257879941717:  Hold'em No Limit ($0.02/$0.05) - 2025/09/25 19:25:05 JST [2025/09/25 6:25:05 ET]
Table 'Donati' 6-max Seat #1 is the button
Seat 1: Irrubikajs ($2.65 in chips) 
Seat 2: FakaN4Kavera ($5 in chips) 
Seat 3: coolDadJimbo ($5 in chips) 
Seat 4: kmc4444 ($5 in chips) 
Seat 5: BrickByBrick68 ($18.65 in chips) 
Seat 6: Epist461 ($5.22 in chips) 
FakaN4Kavera: posts small blind $0.02
coolDadJimbo: posts big blind $0.05
*** HOLE CARDS ***
Dealt to FakaN4Kavera [Jd Ad]
kmc4444: folds 
BrickByBrick68: raises $0.07 to $0.12
Epist461: folds 
Irrubikajs: folds 
FakaN4Kavera: calls $0.10
coolDadJimbo: folds 
*** FLOP *** [4s 4d 5c]
FakaN4Kavera: checks 
BrickByBrick68: checks 
*** TURN *** [4s 4d 5c] [Tc]
FakaN4Kavera: checks 
BrickByBrick68: bets $0.19
FakaN4Kavera: folds 
Uncalled bet ($0.19) returned to BrickByBrick68
BrickByBrick68 collected $0.28 from pot
BrickByBrick68: doesn't show hand 
*** SUMMARY ***
Total pot $0.29 | Rake $0.01 
Board [4s 4d 5c Tc]
Seat 1: Irrubikajs (button) folded before Flop (didn't bet)
Seat 2: FakaN4Kavera (small blind) folded on the Turn
Seat 3: coolDadJimbo (big blind) folded before Flop
Seat 4: kmc4444 folded before Flop (didn't bet)
Seat 5: BrickByBrick68 collected ($0.28)
Seat 6: Epist461 folded before Flop (didn't bet)



PokerStars Zoom Hand #257879946578:  Hold'em No Limit ($0.02/$0.05) - 2025/09/25 19:25:57 JST [2025/09/25 6:25:57 ET]
Table 'Donati' 6-max Seat #1 is the button
Seat 1: FakaN4Kavera ($5 in chips) 
Seat 2: Irrubikajs ($2.60 in chips) 
Seat 3: koshchey_a ($6.95 in chips) 
Seat 4: egoor199 ($3.73 in chips) 
Seat 5: snake oil 12 ($5.36 in chips) 
Seat 6: Kenzo2211 ($8.52 in chips) 
Irrubikajs: posts small blind $0.02
koshchey_a: posts big blind $0.05
*** HOLE CARDS ***
Dealt to FakaN4Kavera [4h 8c]
egoor199: folds 
snake oil 12: folds 
Kenzo2211: folds 
FakaN4Kavera: folds 
Irrubikajs: folds 
Uncalled bet ($0.03) returned to koshchey_a
koshchey_a collected $0.04 from pot
koshchey_a: doesn't show hand 
*** SUMMARY ***
Total pot $0.04 | Rake $0 
Seat 1: FakaN4Kavera (button) folded before Flop (didn't bet)
Seat 2: Irrubikajs (small blind) folded before Flop
Seat 3: koshchey_a (big blind) collected ($0.04)
Seat 4: egoor199 folded before Flop (didn't bet)
Seat 5: snake oil 12 folded before Flop (didn't bet)
Seat 6: Kenzo2211 folded before Flop (didn't bet)



PokerStars Zoom Hand #257879947466:  Hold'em No Limit ($0.02/$0.05) - 2025/09/25 19:26:07 JST [2025/09/25 6:26:07 ET]
Table 'Donati' 6-max Seat #1 is the button
Seat 1: bigdaveys ($11.69 in chips) 
Seat 2: gio119 ($5.31 in chips) 
Seat 3: Lorin22 ($5.52 in chips) 
Seat 4: Gogart87 ($6.81 in chips) 
Seat 5: Woidprophet ($5.79 in chips) 
Seat 6: FakaN4Kavera ($5 in chips) 
gio119: posts small blind $0.02
Lorin22: posts big blind $0.05
*** HOLE CARDS ***
Dealt to FakaN4Kavera [Ad Js]
Gogart87: folds 
Woidprophet: folds 
FakaN4Kavera: raises $0.07 to $0.12
bigdaveys: folds 
gio119: folds 
Lorin22: folds 
Uncalled bet ($0.07) returned to FakaN4Kavera
FakaN4Kavera collected $0.12 from pot
FakaN4Kavera: doesn't show hand 
*** SUMMARY ***
Total pot $0.12 | Rake $0 
Seat 1: bigdaveys (button) folded before Flop (didn't bet)
Seat 2: gio119 (small blind) folded before Flop
Seat 3: Lorin22 (big blind) folded before Flop
Seat 4: Gogart87 folded before Flop (didn't bet)
Seat 5: Woidprophet folded before Flop (didn't bet)
Seat 6: FakaN4Kavera collected ($0.12)



PokerStars Zoom Hand #257879948926:  Hold'em No Limit ($0.02/$0.05) - 2025/09/25 19:26:23 JST [2025/09/25 6:26:23 ET]
Table 'Donati' 6-max Seat #1 is the button
Seat 1: sepik200 ($5.36 in chips) 
Seat 2: intentii ($6.74 in chips) 
Seat 3: egoor199 ($3.73 in chips) 
Seat 4: huyjokezy ($5 in chips) 
Seat 5: FakaN4Kavera ($5.07 in chips) 
Seat 6: Choi Moneky ($5.36 in chips) 
intentii: posts small blind $0.02
egoor199: posts big blind $0.05
*** HOLE CARDS ***
Dealt to FakaN4Kavera [7s 3d]
huyjokezy: raises $0.10 to $0.15
FakaN4Kavera: folds 
Choi Moneky: folds 
sepik200: folds 
intentii: calls $0.13
egoor199: folds 
*** FLOP *** [Th 6h 4c]
intentii: checks 
huyjokezy: checks 
*** TURN *** [Th 6h 4c] [Td]
intentii: bets $0.26
huyjokezy: folds 
Uncalled bet ($0.26) returned to intentii
intentii collected $0.34 from pot
intentii: doesn't show hand 
*** SUMMARY ***
Total pot $0.35 | Rake $0.01 
Board [Th 6h 4c Td]
Seat 1: sepik200 (button) folded before Flop (didn't bet)
Seat 2: intentii (small blind) collected ($0.34)
Seat 3: egoor199 (big blind) folded before Flop
Seat 4: huyjokezy folded on the Turn
Seat 5: FakaN4Kavera folded before Flop (didn't bet)
Seat 6: Choi Moneky folded before Flop (didn't bet)



PokerStars Zoom Hand #257879949412:  Hold'em No Limit ($0.02/$0.05) - 2025/09/25 19:26:28 JST [2025/09/25 6:26:28 ET]
Table 'Donati' 6-max Seat #1 is the button
Seat 1: Woidprophet ($10.86 in chips) 
Seat 2: BretticusX ($6.16 in chips) 
Seat 3: Junney Jade ($2.50 in chips) 
Seat 4: FakaN4Kavera ($5.07 in chips) 
Seat 5: TTPP92 ($4.42 in chips) 
Seat 6: intentii ($5 in chips) 
BretticusX: posts small blind $0.02
Junney Jade: posts big blind $0.05
*** HOLE CARDS ***
Dealt to FakaN4Kavera [Qs As]
FakaN4Kavera: raises $0.07 to $0.12
TTPP92: folds 
intentii: folds 
Woidprophet: calls $0.12
BretticusX: folds 
Junney Jade: calls $0.07
*** FLOP *** [Ad 7s 2h]
Junney Jade: checks 
FakaN4Kavera: bets $0.18
Woidprophet: calls $0.18
Junney Jade: folds 
*** TURN *** [Ad 7s 2h] [4s]
FakaN4Kavera: bets $0.36
Woidprophet: raises $0.59 to $0.95
FakaN4Kavera: calls $0.59
*** RIVER *** [Ad 7s 2h 4s] [8h]
FakaN4Kavera: checks 
Woidprophet: bets $1.27
FakaN4Kavera: calls $1.27
*** SHOW DOWN ***
Woidprophet: shows [2d 2c] (three of a kind, Deuces)
FakaN4Kavera: mucks hand 
Woidprophet collected $4.92 from pot
*** SUMMARY ***
Total pot $5.18 | Rake $0.26 
Board [Ad 7s 2h 4s 8h]
Seat 1: Woidprophet (button) showed [2d 2c] and won ($4.92) with three of a kind, Deuces
Seat 2: BretticusX (small blind) folded before Flop
Seat 3: Junney Jade (big blind) folded on the Flop
Seat 4: FakaN4Kavera mucked [Qs As]
Seat 5: TTPP92 folded before Flop (didn't bet)
Seat 6: intentii folded before Flop (didn't bet)



PokerStars Zoom Hand #257879953455:  Hold'em No Limit ($0.02/$0.05) - 2025/09/25 19:27:13 JST [2025/09/25 6:27:13 ET]
Table 'Donati' 6-max Seat #1 is the button
Seat 1: Kenzo2211 ($8.55 in chips) 
Seat 2: FakaN4Kavera ($5 in chips) 
Seat 3: gio119 ($5 in chips) 
Seat 4: Irrubikajs ($2.50 in chips) 
Seat 5: 1Kronos ($10.38 in chips) 
Seat 6: Ingyeoking ($9.47 in chips) 
FakaN4Kavera: posts small blind $0.02
gio119: posts big blind $0.05
*** HOLE CARDS ***
Dealt to FakaN4Kavera [6h Ts]
Irrubikajs: folds 
1Kronos: folds 
Ingyeoking: folds 
Kenzo2211: folds 
FakaN4Kavera: folds 
Uncalled bet ($0.03) returned to gio119
gio119 collected $0.04 from pot
gio119: doesn't show hand 
*** SUMMARY ***
Total pot $0.04 | Rake $0 
Seat 1: Kenzo2211 (button) folded before Flop (didn't bet)
Seat 2: FakaN4Kavera (small blind) folded before Flop
Seat 3: gio119 (big blind) collected ($0.04)
Seat 4: Irrubikajs folded before Flop (didn't bet)
Seat 5: 1Kronos folded before Flop (didn't bet)
Seat 6: Ingyeoking folded before Flop (didn't bet)



PokerStars Zoom Hand #257879953872:  Hold'em No Limit ($0.02/$0.05) - 2025/09/25 19:27:18 JST [2025/09/25 6:27:18 ET]
Table 'Donati' 6-max Seat #1 is the button
Seat 1: franks270 ($7.83 in chips) 
Seat 2: Kenzo2211 ($8.55 in chips) 
Seat 3: FakaN4Kavera ($5 in chips) 
Seat 4: Irrubikajs ($2.50 in chips) 
Seat 5: intentii ($5.09 in chips) 
Seat 6: egoor199 ($6.03 in chips) 
Kenzo2211: posts small blind $0.02
FakaN4Kavera: posts big blind $0.05
*** HOLE CARDS ***
Dealt to FakaN4Kavera [9s 6d]
Irrubikajs: folds 
intentii: folds 
egoor199: folds 
franks270: calls $0.05
Kenzo2211: folds 
FakaN4Kavera: checks 
*** FLOP *** [3d Qc 7s]
FakaN4Kavera: checks 
franks270: bets $0.05
FakaN4Kavera: folds 
Uncalled bet ($0.05) returned to franks270
franks270 collected $0.12 from pot
franks270: doesn't show hand 
*** SUMMARY ***
Total pot $0.12 | Rake $0 
Board [3d Qc 7s]
Seat 1: franks270 (button) collected ($0.12)
Seat 2: Kenzo2211 (small blind) folded before Flop
Seat 3: FakaN4Kavera (big blind) folded on the Flop
Seat 4: Irrubikajs folded before Flop (didn't bet)
Seat 5: intentii folded before Flop (didn't bet)
Seat 6: egoor199 folded before Flop (didn't bet)



PokerStars Zoom Hand #257879956912:  Hold'em No Limit ($0.02/$0.05) - 2025/09/25 19:27:51 JST [2025/09/25 6:27:51 ET]
Table 'Donati' 6-max Seat #1 is the button
Seat 1: FakaN4Kavera ($5 in chips) 
Seat 2: Choi Moneky ($5.75 in chips) 
Seat 3: Gogart87 ($5.04 in chips) 
Seat 4: gio119 ($5.02 in chips) 
Seat 5: BretticusX ($6.09 in chips) 
Seat 6: Epist461 ($5.43 in chips) 
Choi Moneky: posts small blind $0.02
Gogart87: posts big blind $0.05
*** HOLE CARDS ***
Dealt to FakaN4Kavera [Ts 8c]
gio119: folds 
BretticusX: folds 
Epist461: folds 
FakaN4Kavera: folds 
Choi Moneky: folds 
Uncalled bet ($0.03) returned to Gogart87
Gogart87 collected $0.04 from pot
Gogart87: doesn't show hand 
*** SUMMARY ***
Total pot $0.04 | Rake $0 
Seat 1: FakaN4Kavera (button) folded before Flop (didn't bet)
Seat 2: Choi Moneky (small blind) folded before Flop
Seat 3: Gogart87 (big blind) collected ($0.04)
Seat 4: gio119 folded before Flop (didn't bet)
Seat 5: BretticusX folded before Flop (didn't bet)
Seat 6: Epist461 folded before Flop (didn't bet)



PokerStars Zoom Hand #257879957452:  Hold'em No Limit ($0.02/$0.05) - 2025/09/25 19:27:57 JST [2025/09/25 6:27:57 ET]
Table 'Donati' 6-max Seat #1 is the button
Seat 1: DurandalMIA ($5.13 in chips) 
Seat 2: TTPP92 ($4.23 in chips) 
Seat 3: _jay_44_jas ($6.80 in chips) 
Seat 4: Ingyeoking ($5.41 in chips) 
Seat 5: scottie4barnes ($8.98 in chips) 
Seat 6: FakaN4Kavera ($5 in chips) 
TTPP92: posts small blind $0.02
_jay_44_jas: posts big blind $0.05
*** HOLE CARDS ***
Dealt to FakaN4Kavera [Th 7c]
Ingyeoking: folds 
scottie4barnes: folds 
FakaN4Kavera: folds 
DurandalMIA: folds 
TTPP92: raises $0.05 to $0.10
_jay_44_jas: folds 
Uncalled bet ($0.05) returned to TTPP92
TTPP92 collected $0.10 from pot
TTPP92: doesn't show hand 
*** SUMMARY ***
Total pot $0.10 | Rake $0 
Seat 1: DurandalMIA (button) folded before Flop (didn't bet)
Seat 2: TTPP92 (small blind) collected ($0.10)
Seat 3: _jay_44_jas (big blind) folded before Flop
Seat 4: Ingyeoking folded before Flop (didn't bet)
Seat 5: scottie4barnes folded before Flop (didn't bet)
Seat 6: FakaN4Kavera folded before Flop (didn't bet)



PokerStars Zoom Hand #257879958390:  Hold'em No Limit ($0.02/$0.05) - 2025/09/25 19:28:07 JST [2025/09/25 6:28:07 ET]
Table 'Donati' 6-max Seat #1 is the button
Seat 1: elmex886 ($5 in chips) 
Seat 2: Vasco4430 ($8.63 in chips) 
Seat 3: zodapoker ($4.47 in chips) 
Seat 4: FakaN4Kavera ($5 in chips) 
Seat 5: delfinato200 ($14.23 in chips) 
Seat 6: bigdaveys ($11.95 in chips) 
Vasco4430: posts small blind $0.02
zodapoker: posts big blind $0.05
*** HOLE CARDS ***
Dealt to FakaN4Kavera [5h Ac]
FakaN4Kavera: folds 
delfinato200: folds 
bigdaveys: raises $0.07 to $0.12
elmex886: folds 
Vasco4430: folds 
zodapoker: folds 
Uncalled bet ($0.07) returned to bigdaveys
bigdaveys collected $0.12 from pot
bigdaveys: doesn't show hand 
*** SUMMARY ***
Total pot $0.12 | Rake $0 
Seat 1: elmex886 (button) folded before Flop (didn't bet)
Seat 2: Vasco4430 (small blind) folded before Flop
Seat 3: zodapoker (big blind) folded before Flop
Seat 4: FakaN4Kavera folded before Flop (didn't bet)
Seat 5: delfinato200 folded before Flop (didn't bet)
Seat 6: bigdaveys collected ($0.12)



PokerStars Zoom Hand #257879957933:  Hold'em No Limit ($0.02/$0.05) - 2025/09/25 19:28:02 JST [2025/09/25 6:28:02 ET]
Table 'Donati' 6-max Seat #1 is the button
Seat 1: Ingyeoking ($5.41 in chips) 
Seat 2: goaßmaß-fips ($7.48 in chips) 
Seat 3: gio119 ($5.02 in chips) 
Seat 4: Baikasas ($5.75 in chips) 
Seat 5: FakaN4Kavera ($5 in chips) 
Seat 6: delfinato200 ($14.23 in chips) 
goaßmaß-fips: posts small blind $0.02
gio119: posts big blind $0.05
*** HOLE CARDS ***
Dealt to FakaN4Kavera [4h Kd]
Baikasas: folds 
FakaN4Kavera: folds 
delfinato200: folds 
Ingyeoking: raises $0.07 to $0.12
goaßmaß-fips: folds 
gio119: folds 
Uncalled bet ($0.07) returned to Ingyeoking
Ingyeoking collected $0.12 from pot
Ingyeoking: doesn't show hand 
*** SUMMARY ***
Total pot $0.12 | Rake $0 
Seat 1: Ingyeoking (button) collected ($0.12)
Seat 2: goaßmaß-fips (small blind) folded before Flop
Seat 3: gio119 (big blind) folded before Flop
Seat 4: Baikasas folded before Flop (didn't bet)
Seat 5: FakaN4Kavera folded before Flop (didn't bet)
Seat 6: delfinato200 folded before Flop (didn't bet)



PokerStars Zoom Hand #257879958977:  Hold'em No Limit ($0.02/$0.05) - 2025/09/25 19:28:13 JST [2025/09/25 6:28:13 ET]
Table 'Donati' 6-max Seat #1 is the button
Seat 1: tomis1312 ($5 in chips) 
Seat 2: elmex886 ($5 in chips) 
Seat 3: FakaN4Kavera ($5 in chips) 
Seat 4: _jay_44_jas ($6.75 in chips) 
Seat 5: intentii ($5.40 in chips) 
Seat 6: Baikasas ($5.75 in chips) 
elmex886: posts small blind $0.02
FakaN4Kavera: posts big blind $0.05
*** HOLE CARDS ***
Dealt to FakaN4Kavera [5d 8c]
_jay_44_jas: folds 
intentii: folds 
Baikasas: raises $0.06 to $0.11
tomis1312: folds 
elmex886: folds 
FakaN4Kavera: folds 
Uncalled bet ($0.06) returned to Baikasas
Baikasas collected $0.12 from pot
Baikasas: doesn't show hand 
*** SUMMARY ***
Total pot $0.12 | Rake $0 
Seat 1: tomis1312 (button) folded before Flop (didn't bet)
Seat 2: elmex886 (small blind) folded before Flop
Seat 3: FakaN4Kavera (big blind) folded before Flop
Seat 4: _jay_44_jas folded before Flop (didn't bet)
Seat 5: intentii folded before Flop (didn't bet)
Seat 6: Baikasas collected ($0.12)



PokerStars Zoom Hand #257879959974:  Hold'em No Limit ($0.02/$0.05) - 2025/09/25 19:28:24 JST [2025/09/25 6:28:24 ET]
Table 'Donati' 6-max Seat #1 is the button
Seat 1: goaßmaß-fips ($7.53 in chips) 
Seat 2: FakaN4Kavera ($5 in chips) 
Seat 3: koshchey_a ($6.95 in chips) 
Seat 4: 1Kronos ($15.18 in chips) 
Seat 5: gio119 ($9.95 in chips) 
Seat 6: TTPP92 ($4.26 in chips) 
FakaN4Kavera: posts small blind $0.02
koshchey_a: posts big blind $0.05
*** HOLE CARDS ***
Dealt to FakaN4Kavera [2s 3c]
1Kronos: folds 
gio119: folds 
TTPP92: folds 
goaßmaß-fips: raises $0.10 to $0.15
FakaN4Kavera: folds 
koshchey_a: folds 
Uncalled bet ($0.10) returned to goaßmaß-fips
goaßmaß-fips collected $0.12 from pot
goaßmaß-fips: doesn't show hand 
*** SUMMARY ***
Total pot $0.12 | Rake $0 
Seat 1: goaßmaß-fips (button) collected ($0.12)
Seat 2: FakaN4Kavera (small blind) folded before Flop
Seat 3: koshchey_a (big blind) folded before Flop
Seat 4: 1Kronos folded before Flop (didn't bet)
Seat 5: gio119 folded before Flop (didn't bet)
Seat 6: TTPP92 folded before Flop (didn't bet)



PokerStars Zoom Hand #257879961152:  Hold'em No Limit ($0.02/$0.05) - 2025/09/25 19:28:37 JST [2025/09/25 6:28:37 ET]
Table 'Donati' 6-max Seat #1 is the button
Seat 1: VXNX$157 ($4.33 in chips) 
Seat 2: kalopara ($4.95 in chips) 
Seat 3: Gogart87 ($5.82 in chips) 
Seat 4: FakaN4Kavera ($5 in chips) 
Seat 5: gm__701 ($5.38 in chips) 
Seat 6: Epist461 ($5.57 in chips) 
kalopara: posts small blind $0.02
Gogart87: posts big blind $0.05
*** HOLE CARDS ***
Dealt to FakaN4Kavera [Td Ts]
FakaN4Kavera: raises $0.07 to $0.12
gm__701: folds 
Epist461: raises $0.24 to $0.36
VXNX$157: folds 
kalopara: folds 
Gogart87: folds 
FakaN4Kavera: calls $0.24
*** FLOP *** [4c 5h Qc]
FakaN4Kavera: checks 
Epist461: bets $0.25
FakaN4Kavera: calls $0.25
*** TURN *** [4c 5h Qc] [Ac]
FakaN4Kavera: checks 
Epist461: checks 
*** RIVER *** [4c 5h Qc Ac] [Qs]
FakaN4Kavera: checks 
Epist461: bets $0.84
FakaN4Kavera: folds 
Uncalled bet ($0.84) returned to Epist461
Epist461 collected $1.24 from pot
Epist461: doesn't show hand 
*** SUMMARY ***
Total pot $1.29 | Rake $0.05 
Board [4c 5h Qc Ac Qs]
Seat 1: VXNX$157 (button) folded before Flop (didn't bet)
Seat 2: kalopara (small blind) folded before Flop
Seat 3: Gogart87 (big blind) folded before Flop
Seat 4: FakaN4Kavera folded on the River
Seat 5: gm__701 folded before Flop (didn't bet)
Seat 6: Epist461 collected ($1.24)



PokerStars Zoom Hand #257879968298:  Hold'em No Limit ($0.02/$0.05) - 2025/09/25 19:29:52 JST [2025/09/25 6:29:52 ET]
Table 'Donati' 6-max Seat #1 is the button
Seat 1: FakaN4Kavera ($5 in chips) 
Seat 2: _jay_44_jas ($7.25 in chips) 
Seat 3: Schöngeist71 ($7.58 in chips) 
Seat 4: TTPP92 ($5.18 in chips) 
Seat 5: 1Kronos ($15.73 in chips) 
Seat 6: Ingyeoking ($5.53 in chips) 
_jay_44_jas: posts small blind $0.02
Schöngeist71: posts big blind $0.05
*** HOLE CARDS ***
Dealt to FakaN4Kavera [Jc 4c]
TTPP92: folds 
1Kronos: folds 
Ingyeoking: raises $0.07 to $0.12
FakaN4Kavera: folds 
_jay_44_jas: folds 
Schöngeist71: calls $0.07
*** FLOP *** [Qc Ks 2h]
Schöngeist71: checks 
Ingyeoking: bets $0.08
Schöngeist71: folds 
Uncalled bet ($0.08) returned to Ingyeoking
Ingyeoking collected $0.25 from pot
Ingyeoking: doesn't show hand 
*** SUMMARY ***
Total pot $0.26 | Rake $0.01 
Board [Qc Ks 2h]
Seat 1: FakaN4Kavera (button) folded before Flop (didn't bet)
Seat 2: _jay_44_jas (small blind) folded before Flop
Seat 3: Schöngeist71 (big blind) folded on the Flop
Seat 4: TTPP92 folded before Flop (didn't bet)
Seat 5: 1Kronos folded before Flop (didn't bet)
Seat 6: Ingyeoking collected ($0.25)



PokerStars Zoom Hand #257879969638:  Hold'em No Limit ($0.02/$0.05) - 2025/09/25 19:30:06 JST [2025/09/25 6:30:06 ET]
Table 'Donati' 6-max Seat #1 is the button
Seat 1: YAG5292 ($6.04 in chips) 
Seat 2: tomis1312 ($5 in chips) 
Seat 3: Baikasas ($5 in chips) 
Seat 4: DurandalMIA ($5.47 in chips) 
Seat 5: Ingyeoking ($9.57 in chips) 
Seat 6: FakaN4Kavera ($5 in chips) 
tomis1312: posts small blind $0.02
Baikasas: posts big blind $0.05
*** HOLE CARDS ***
Dealt to FakaN4Kavera [3s 8c]
DurandalMIA: folds 
Ingyeoking: folds 
FakaN4Kavera: folds 
YAG5292: folds 
tomis1312: raises $0.10 to $0.15
Baikasas: raises $0.30 to $0.45
tomis1312: folds 
Uncalled bet ($0.30) returned to Baikasas
Baikasas collected $0.30 from pot
Baikasas: doesn't show hand 
*** SUMMARY ***
Total pot $0.30 | Rake $0 
Seat 1: YAG5292 (button) folded before Flop (didn't bet)
Seat 2: tomis1312 (small blind) folded before Flop
Seat 3: Baikasas (big blind) collected ($0.30)
Seat 4: DurandalMIA folded before Flop (didn't bet)
Seat 5: Ingyeoking folded before Flop (didn't bet)
Seat 6: FakaN4Kavera folded before Flop (didn't bet)



PokerStars Zoom Hand #257879970976:  Hold'em No Limit ($0.02/$0.05) - 2025/09/25 19:30:20 JST [2025/09/25 6:30:20 ET]
Table 'Donati' 6-max Seat #1 is the button
Seat 1: 1Kronos ($10.07 in chips) 
Seat 2: egoor199 ($3.61 in chips) 
Seat 3: dervoigt ($5 in chips) 
Seat 4: Epist461 ($5.20 in chips) 
Seat 5: FakaN4Kavera ($5 in chips) 
Seat 6: serg430606 ($5.15 in chips) 
egoor199: posts small blind $0.02
dervoigt: posts big blind $0.05
*** HOLE CARDS ***
Dealt to FakaN4Kavera [4c 7s]
Epist461: raises $0.05 to $0.10
FakaN4Kavera: folds 
serg430606: folds 
1Kronos: raises $0.28 to $0.38
egoor199: folds 
dervoigt: folds 
Epist461: folds 
Uncalled bet ($0.28) returned to 1Kronos
1Kronos collected $0.27 from pot
1Kronos: doesn't show hand 
*** SUMMARY ***
Total pot $0.27 | Rake $0 
Seat 1: 1Kronos (button) collected ($0.27)
Seat 2: egoor199 (small blind) folded before Flop
Seat 3: dervoigt (big blind) folded before Flop
Seat 4: Epist461 folded before Flop
Seat 5: FakaN4Kavera folded before Flop (didn't bet)
Seat 6: serg430606 folded before Flop (didn't bet)



PokerStars Zoom Hand #257879971896:  Hold'em No Limit ($0.02/$0.05) - 2025/09/25 19:30:30 JST [2025/09/25 6:30:30 ET]
Table 'Donati' 6-max Seat #1 is the button
Seat 1: Ingyeoking ($9.52 in chips) 
Seat 2: Baikasas ($5.46 in chips) 
Seat 3: FakaN4Kavera ($5 in chips) 
Seat 4: VXNX$157 ($4.47 in chips) 
Seat 5: serg430606 ($5.13 in chips) 
Seat 6: Fercoronas ($2.28 in chips) 
Baikasas: posts small blind $0.02
FakaN4Kavera: posts big blind $0.05
*** HOLE CARDS ***
Dealt to FakaN4Kavera [9d 7h]
VXNX$157: folds 
serg430606: folds 
Fercoronas: folds 
Ingyeoking: folds 
Baikasas: folds 
Uncalled bet ($0.03) returned to FakaN4Kavera
FakaN4Kavera collected $0.04 from pot
FakaN4Kavera: doesn't show hand 
*** SUMMARY ***
Total pot $0.04 | Rake $0 
Seat 1: Ingyeoking (button) folded before Flop (didn't bet)
Seat 2: Baikasas (small blind) folded before Flop
Seat 3: FakaN4Kavera (big blind) collected ($0.04)
Seat 4: VXNX$157 folded before Flop (didn't bet)
Seat 5: serg430606 folded before Flop (didn't bet)
Seat 6: Fercoronas folded before Flop (didn't bet)



PokerStars Zoom Hand #257879970478:  Hold'em No Limit ($0.02/$0.05) - 2025/09/25 19:30:15 JST [2025/09/25 6:30:15 ET]
Table 'Donati' 6-max Seat #1 is the button
Seat 1: Ingyeoking ($2.70 in chips) 
Seat 2: gena60 ($11.81 in chips) 
Seat 3: intentii ($5.31 in chips) 
Seat 4: YAG5292 ($9.33 in chips) 
Seat 5: gio119 ($5.14 in chips) 
Seat 6: FakaN4Kavera ($5 in chips) 
gena60: posts small blind $0.02
intentii: posts big blind $0.05
*** HOLE CARDS ***
Dealt to FakaN4Kavera [Kh 4d]
YAG5292: folds 
gio119: folds 
FakaN4Kavera: folds 
Ingyeoking: folds 
gena60: raises $0.15 to $0.20
intentii: raises $0.62 to $0.82
gena60: folds 
Uncalled bet ($0.62) returned to intentii
intentii collected $0.40 from pot
intentii: doesn't show hand 
*** SUMMARY ***
Total pot $0.40 | Rake $0 
Seat 1: Ingyeoking (button) folded before Flop (didn't bet)
Seat 2: gena60 (small blind) folded before Flop
Seat 3: intentii (big blind) collected ($0.40)
Seat 4: YAG5292 folded before Flop (didn't bet)
Seat 5: gio119 folded before Flop (didn't bet)
Seat 6: FakaN4Kavera folded before Flop (didn't bet)



PokerStars Zoom Hand #257879973323:  Hold'em No Limit ($0.02/$0.05) - 2025/09/25 19:30:46 JST [2025/09/25 6:30:46 ET]
Table 'Donati' 6-max Seat #1 is the button
Seat 1: egoor199 ($6.42 in chips) 
Seat 2: FakaN4Kavera ($5.02 in chips) 
Seat 3: tomis1312 ($5 in chips) 
Seat 4: YAG5292 ($9.40 in chips) 
Seat 5: Ingyeoking ($4.02 in chips) 
Seat 6: serg430606 ($5.13 in chips) 
FakaN4Kavera: posts small blind $0.02
tomis1312: posts big blind $0.05
*** HOLE CARDS ***
Dealt to FakaN4Kavera [Ac Kh]
YAG5292: folds 
Ingyeoking: raises $0.05 to $0.10
serg430606: folds 
egoor199: folds 
FakaN4Kavera: raises $0.25 to $0.35
tomis1312: folds 
Ingyeoking: calls $0.25
*** FLOP *** [9h Tc 2h]
FakaN4Kavera: checks 
Ingyeoking: bets $0.24
FakaN4Kavera: calls $0.24
*** TURN *** [9h Tc 2h] [7s]
FakaN4Kavera: checks 
Ingyeoking: bets $0.89
FakaN4Kavera: folds 
Uncalled bet ($0.89) returned to Ingyeoking
Ingyeoking collected $1.18 from pot
Ingyeoking: doesn't show hand 
*** SUMMARY ***
Total pot $1.23 | Rake $0.05 
Board [9h Tc 2h 7s]
Seat 1: egoor199 (button) folded before Flop (didn't bet)
Seat 2: FakaN4Kavera (small blind) folded on the Turn
Seat 3: tomis1312 (big blind) folded before Flop
Seat 4: YAG5292 folded before Flop (didn't bet)
Seat 5: Ingyeoking collected ($1.18)
Seat 6: serg430606 folded before Flop (didn't bet)



PokerStars Zoom Hand #257879977191:  Hold'em No Limit ($0.02/$0.05) - 2025/09/25 19:31:27 JST [2025/09/25 6:31:27 ET]
Table 'Donati' 6-max Seat #1 is the button
Seat 1: intentii ($5.49 in chips) 
Seat 2: gio119 ($5.28 in chips) 
Seat 3: koshchey_a ($6.14 in chips) 
Seat 4: goaßmaß-fips ($12.37 in chips) 
Seat 5: FakaN4Kavera ($5 in chips) 
Seat 6: gm__701 ($5 in chips) 
gio119: posts small blind $0.02
koshchey_a: posts big blind $0.05
*** HOLE CARDS ***
Dealt to FakaN4Kavera [Th 4s]
goaßmaß-fips: folds 
FakaN4Kavera: folds 
gm__701: folds 
intentii: folds 
gio119: folds 
Uncalled bet ($0.03) returned to koshchey_a
koshchey_a collected $0.04 from pot
koshchey_a: doesn't show hand 
*** SUMMARY ***
Total pot $0.04 | Rake $0 
Seat 1: intentii (button) folded before Flop (didn't bet)
Seat 2: gio119 (small blind) folded before Flop
Seat 3: koshchey_a (big blind) collected ($0.04)
Seat 4: goaßmaß-fips folded before Flop (didn't bet)
Seat 5: FakaN4Kavera folded before Flop (didn't bet)
Seat 6: gm__701 folded before Flop (didn't bet)



PokerStars Zoom Hand #257879977796:  Hold'em No Limit ($0.02/$0.05) - 2025/09/25 19:31:33 JST [2025/09/25 6:31:33 ET]
Table 'Donati' 6-max Seat #1 is the button
Seat 1: FakaN4Kavera ($5 in chips) 
Seat 2: 1Kronos ($8.05 in chips) 
Seat 3: Gogart87 ($5.26 in chips) 
Seat 4: Baikasas ($5.25 in chips) 
Seat 5: koshchey_a ($7.32 in chips) 
Seat 6: gio119 ($5 in chips) 
1Kronos: posts small blind $0.02
Gogart87: posts big blind $0.05
*** HOLE CARDS ***
Dealt to FakaN4Kavera [3h 4h]
Baikasas: folds 
koshchey_a: folds 
gio119: folds 
FakaN4Kavera: raises $0.07 to $0.12
1Kronos: folds 
Gogart87: folds 
Uncalled bet ($0.07) returned to FakaN4Kavera
FakaN4Kavera collected $0.12 from pot
FakaN4Kavera: doesn't show hand 
*** SUMMARY ***
Total pot $0.12 | Rake $0 
Seat 1: FakaN4Kavera (button) collected ($0.12)
Seat 2: 1Kronos (small blind) folded before Flop
Seat 3: Gogart87 (big blind) folded before Flop
Seat 4: Baikasas folded before Flop (didn't bet)
Seat 5: koshchey_a folded before Flop (didn't bet)
Seat 6: gio119 folded before Flop (didn't bet)



PokerStars Zoom Hand #257879979387:  Hold'em No Limit ($0.02/$0.05) - 2025/09/25 19:31:51 JST [2025/09/25 6:31:51 ET]
Table 'Donati' 6-max Seat #1 is the button
Seat 1: intentii ($5.09 in chips) 
Seat 2: Gogart87 ($5.21 in chips) 
Seat 3: dervoigt ($4.43 in chips) 
Seat 4: 1Kronos ($11.26 in chips) 
Seat 5: FakaN4Kavera ($5.07 in chips) 
Seat 6: Ingyeoking ($2.88 in chips) 
Gogart87: posts small blind $0.02
dervoigt: posts big blind $0.05
*** HOLE CARDS ***
Dealt to FakaN4Kavera [As 9d]
1Kronos: folds 
FakaN4Kavera: folds 
Ingyeoking: raises $0.07 to $0.12
intentii: folds 
Gogart87: folds 
dervoigt: folds 
Uncalled bet ($0.07) returned to Ingyeoking
Ingyeoking collected $0.12 from pot
Ingyeoking: doesn't show hand 
*** SUMMARY ***
Total pot $0.12 | Rake $0 
Seat 1: intentii (button) folded before Flop (didn't bet)
Seat 2: Gogart87 (small blind) folded before Flop
Seat 3: dervoigt (big blind) folded before Flop
Seat 4: 1Kronos folded before Flop (didn't bet)
Seat 5: FakaN4Kavera folded before Flop (didn't bet)
Seat 6: Ingyeoking collected ($0.12)



PokerStars Zoom Hand #257879979843:  Hold'em No Limit ($0.02/$0.05) - 2025/09/25 19:31:56 JST [2025/09/25 6:31:56 ET]
Table 'Donati' 6-max Seat #1 is the button
Seat 1: intentii ($5.07 in chips) 
Seat 2: YAG5292 ($9.14 in chips) 
Seat 3: FakaN4Kavera ($5.07 in chips) 
Seat 4: 1Kronos ($8.03 in chips) 
Seat 5: zodapoker ($5.76 in chips) 
Seat 6: gio119 ($5.26 in chips) 
YAG5292: posts small blind $0.02
FakaN4Kavera: posts big blind $0.05
*** HOLE CARDS ***
Dealt to FakaN4Kavera [Ts Kd]
1Kronos: folds 
zodapoker: folds 
gio119: folds 
intentii: raises $0.08 to $0.13
YAG5292: folds 
FakaN4Kavera: calls $0.08
*** FLOP *** [Ks 9c 6c]
FakaN4Kavera: checks 
intentii: bets $0.09
FakaN4Kavera: calls $0.09
*** TURN *** [Ks 9c 6c] [6d]
FakaN4Kavera: checks 
intentii: bets $0.33
FakaN4Kavera: calls $0.33
*** RIVER *** [Ks 9c 6c 6d] [6s]
FakaN4Kavera: checks 
intentii: bets $0.80
FakaN4Kavera: calls $0.80
*** SHOW DOWN ***
intentii: shows [Ac Ad] (a full house, Sixes full of Aces)
FakaN4Kavera: mucks hand 
intentii collected $2.61 from pot
*** SUMMARY ***
Total pot $2.72 | Rake $0.11 
Board [Ks 9c 6c 6d 6s]
Seat 1: intentii (button) showed [Ac Ad] and won ($2.61) with a full house, Sixes full of Aces
Seat 2: YAG5292 (small blind) folded before Flop
Seat 3: FakaN4Kavera (big blind) mucked [Ts Kd]
Seat 4: 1Kronos folded before Flop (didn't bet)
Seat 5: zodapoker folded before Flop (didn't bet)
Seat 6: gio119 folded before Flop (didn't bet)



PokerStars Zoom Hand #257879985852:  Hold'em No Limit ($0.02/$0.05) - 2025/09/25 19:32:59 JST [2025/09/25 6:32:59 ET]
Table 'Donati' 6-max Seat #1 is the button
Seat 1: kalopara ($4.56 in chips) 
Seat 2: FakaN4Kavera ($5 in chips) 
Seat 3: Kenzo2211 ($5.88 in chips) 
Seat 4: TTPP92 ($5.01 in chips) 
Seat 5: delfinato200 ($14.54 in chips) 
Seat 6: intentii ($5.04 in chips) 
FakaN4Kavera: posts small blind $0.02
Kenzo2211: posts big blind $0.05
*** HOLE CARDS ***
Dealt to FakaN4Kavera [Kh Jd]
TTPP92: folds 
delfinato200: folds 
intentii: raises $0.08 to $0.13
kalopara: raises $0.32 to $0.45
FakaN4Kavera: folds 
Kenzo2211: folds 
intentii: folds 
Uncalled bet ($0.32) returned to kalopara
kalopara collected $0.33 from pot
kalopara: doesn't show hand 
*** SUMMARY ***
Total pot $0.33 | Rake $0 
Seat 1: kalopara (button) collected ($0.33)
Seat 2: FakaN4Kavera (small blind) folded before Flop
Seat 3: Kenzo2211 (big blind) folded before Flop
Seat 4: TTPP92 folded before Flop (didn't bet)
Seat 5: delfinato200 folded before Flop (didn't bet)
Seat 6: intentii folded before Flop



PokerStars Zoom Hand #257879987315:  Hold'em No Limit ($0.02/$0.05) - 2025/09/25 19:33:14 JST [2025/09/25 6:33:14 ET]
Table 'Donati' 6-max Seat #1 is the button
Seat 1: FakaN4Kavera ($5 in chips) 
Seat 2: tomis1312 ($5 in chips) 
Seat 3: Ingyeoking ($4.22 in chips) 
Seat 4: 1Kronos ($11.19 in chips) 
Seat 5: goaßmaß-fips ($12.95 in chips) 
Seat 6: gio119 ($5.06 in chips) 
tomis1312: posts small blind $0.02
Ingyeoking: posts big blind $0.05
*** HOLE CARDS ***
Dealt to FakaN4Kavera [8d 9h]
1Kronos: folds 
goaßmaß-fips: folds 
gio119: folds 
FakaN4Kavera: folds 
tomis1312: folds 
Uncalled bet ($0.03) returned to Ingyeoking
Ingyeoking collected $0.04 from pot
Ingyeoking: doesn't show hand 
*** SUMMARY ***
Total pot $0.04 | Rake $0 
Seat 1: FakaN4Kavera (button) folded before Flop (didn't bet)
Seat 2: tomis1312 (small blind) folded before Flop
Seat 3: Ingyeoking (big blind) collected ($0.04)
Seat 4: 1Kronos folded before Flop (didn't bet)
Seat 5: goaßmaß-fips folded before Flop (didn't bet)
Seat 6: gio119 folded before Flop (didn't bet)



PokerStars Zoom Hand #257879987807:  Hold'em No Limit ($0.02/$0.05) - 2025/09/25 19:33:19 JST [2025/09/25 6:33:19 ET]
Table 'Donati' 6-max Seat #1 is the button
Seat 1: leakleakA ($12.79 in chips) 
Seat 2: emmachan415 ($5 in chips) 
Seat 3: hugoreisssss ($5 in chips) 
Seat 4: 1Kronos ($10.62 in chips) 
Seat 5: intentii ($5.54 in chips) 
Seat 6: FakaN4Kavera ($5 in chips) 
emmachan415: posts small blind $0.02
hugoreisssss: posts big blind $0.05
*** HOLE CARDS ***
Dealt to FakaN4Kavera [6d 6h]
1Kronos: raises $0.07 to $0.12
intentii: folds 
FakaN4Kavera: calls $0.12
leakleakA: folds 
emmachan415: folds 
hugoreisssss: folds 
*** FLOP *** [9d 4s 9c]
1Kronos: checks 
FakaN4Kavera: checks 
*** TURN *** [9d 4s 9c] [2s]
1Kronos: checks 
FakaN4Kavera: checks 
*** RIVER *** [9d 4s 9c 2s] [5s]
1Kronos: checks 
FakaN4Kavera: checks 
*** SHOW DOWN ***
1Kronos: shows [Ac Qd] (a pair of Nines)
FakaN4Kavera: shows [6d 6h] (two pair, Nines and Sixes)
FakaN4Kavera collected $0.30 from pot
*** SUMMARY ***
Total pot $0.31 | Rake $0.01 
Board [9d 4s 9c 2s 5s]
Seat 1: leakleakA (button) folded before Flop (didn't bet)
Seat 2: emmachan415 (small blind) folded before Flop
Seat 3: hugoreisssss (big blind) folded before Flop
Seat 4: 1Kronos showed [Ac Qd] and lost with a pair of Nines
Seat 5: intentii folded before Flop (didn't bet)
Seat 6: FakaN4Kavera showed [6d 6h] and won ($0.30) with two pair, Nines and Sixes



PokerStars Zoom Hand #257879991958:  Hold'em No Limit ($0.02/$0.05) - 2025/09/25 19:34:01 JST [2025/09/25 6:34:01 ET]
Table 'Donati' 6-max Seat #1 is the button
Seat 1: BretticusX ($5 in chips) 
Seat 2: Ingyeoking ($6.21 in chips) 
Seat 3: FakaN4Kavera ($5.18 in chips) 
Seat 4: Kenzo2211 ($5.99 in chips) 
Seat 5: gio119 ($5.17 in chips) 
Seat 6: kalopara ($4.46 in chips) 
Ingyeoking: posts small blind $0.02
FakaN4Kavera: posts big blind $0.05
*** HOLE CARDS ***
Dealt to FakaN4Kavera [Ah 5d]
Kenzo2211: raises $0.05 to $0.10
gio119: folds 
kalopara: folds 
BretticusX: folds 
Ingyeoking: folds 
FakaN4Kavera: calls $0.05
*** FLOP *** [8h 5h Jh]
FakaN4Kavera: checks 
Kenzo2211: bets $0.05
FakaN4Kavera: raises $0.16 to $0.21
Kenzo2211: calls $0.16
*** TURN *** [8h 5h Jh] [7d]
FakaN4Kavera: checks 
Kenzo2211: checks 
*** RIVER *** [8h 5h Jh 7d] [As]
FakaN4Kavera: bets $0.31
Kenzo2211: calls $0.31
*** SHOW DOWN ***
FakaN4Kavera: shows [Ah 5d] (two pair, Aces and Fives)
Kenzo2211: mucks hand 
FakaN4Kavera collected $1.21 from pot
*** SUMMARY ***
Total pot $1.26 | Rake $0.05 
Board [8h 5h Jh 7d As]
Seat 1: BretticusX (button) folded before Flop (didn't bet)
Seat 2: Ingyeoking (small blind) folded before Flop
Seat 3: FakaN4Kavera (big blind) showed [Ah 5d] and won ($1.21) with two pair, Aces and Fives
Seat 4: Kenzo2211 mucked [Jd Qd]
Seat 5: gio119 folded before Flop (didn't bet)
Seat 6: kalopara folded before Flop (didn't bet)



PokerStars Zoom Hand #257880000695:  Hold'em No Limit ($0.02/$0.05) - 2025/09/25 19:35:31 JST [2025/09/25 6:35:31 ET]
Table 'Donati' 6-max Seat #1 is the button
Seat 1: zodapoker ($4.61 in chips) 
Seat 2: huyjokezy ($5 in chips) 
Seat 3: VXNX$157 ($4.27 in chips) 
Seat 4: kalopara ($4.65 in chips) 
Seat 5: FakaN4Kavera ($5.77 in chips) 
Seat 6: Irrubikajs ($5.84 in chips) 
huyjokezy: posts small blind $0.02
VXNX$157: posts big blind $0.05
*** HOLE CARDS ***
Dealt to FakaN4Kavera [2d Jd]
kalopara: folds 
FakaN4Kavera: folds 
Irrubikajs: folds 
zodapoker: folds 
huyjokezy: folds 
Uncalled bet ($0.03) returned to VXNX$157
VXNX$157 collected $0.04 from pot
VXNX$157: doesn't show hand 
*** SUMMARY ***
Total pot $0.04 | Rake $0 
Seat 1: zodapoker (button) folded before Flop (didn't bet)
Seat 2: huyjokezy (small blind) folded before Flop
Seat 3: VXNX$157 (big blind) collected ($0.04)
Seat 4: kalopara folded before Flop (didn't bet)
Seat 5: FakaN4Kavera folded before Flop (didn't bet)
Seat 6: Irrubikajs folded before Flop (didn't bet)



PokerStars Zoom Hand #257880001996:  Hold'em No Limit ($0.02/$0.05) - 2025/09/25 19:35:44 JST [2025/09/25 6:35:44 ET]
Table 'Donati' 6-max Seat #1 is the button
Seat 1: tomis1312 ($5 in chips) 
Seat 2: Irrubikajs ($5.39 in chips) 
Seat 3: ICallForYou ($4 in chips) 
Seat 4: Ingyeoking ($4.98 in chips) 
Seat 5: FakaN4Kavera ($5.77 in chips) 
Seat 6: huyjokezy ($5 in chips) 
Irrubikajs: posts small blind $0.02
ICallForYou: posts big blind $0.05
*** HOLE CARDS ***
Dealt to FakaN4Kavera [Tc Qd]
Ingyeoking: folds 
FakaN4Kavera: folds 
huyjokezy: folds 
tomis1312: folds 
Irrubikajs: folds 
Uncalled bet ($0.03) returned to ICallForYou
ICallForYou collected $0.04 from pot
ICallForYou: doesn't show hand 
*** SUMMARY ***
Total pot $0.04 | Rake $0 
Seat 1: tomis1312 (button) folded before Flop (didn't bet)
Seat 2: Irrubikajs (small blind) folded before Flop
Seat 3: ICallForYou (big blind) collected ($0.04)
Seat 4: Ingyeoking folded before Flop (didn't bet)
Seat 5: FakaN4Kavera folded before Flop (didn't bet)
Seat 6: huyjokezy folded before Flop (didn't bet)



PokerStars Zoom Hand #257880002852:  Hold'em No Limit ($0.02/$0.05) - 2025/09/25 19:35:53 JST [2025/09/25 6:35:53 ET]
Table 'Donati' 6-max Seat #1 is the button
Seat 1: kalopara ($4.60 in chips) 
Seat 2: 1Kronos ($15.51 in chips) 
Seat 3: gio119 ($5.05 in chips) 
Seat 4: FakaN4Kavera ($5.77 in chips) 
Seat 5: intentii ($7.67 in chips) 
Seat 6: kmc4444 ($6.58 in chips) 
1Kronos: posts small blind $0.02
gio119: posts big blind $0.05
*** HOLE CARDS ***
Dealt to FakaN4Kavera [7s 5s]
FakaN4Kavera: folds 
intentii: folds 
kmc4444: folds 
kalopara: folds 
1Kronos: folds 
Uncalled bet ($0.03) returned to gio119
gio119 collected $0.04 from pot
gio119: doesn't show hand 
*** SUMMARY ***
Total pot $0.04 | Rake $0 
Seat 1: kalopara (button) folded before Flop (didn't bet)
Seat 2: 1Kronos (small blind) folded before Flop
Seat 3: gio119 (big blind) collected ($0.04)
Seat 4: FakaN4Kavera folded before Flop (didn't bet)
Seat 5: intentii folded before Flop (didn't bet)
Seat 6: kmc4444 folded before Flop (didn't bet)



PokerStars Zoom Hand #257880004226:  Hold'em No Limit ($0.02/$0.05) - 2025/09/25 19:36:07 JST [2025/09/25 6:36:07 ET]
Table 'Donati' 6-max Seat #1 is the button
Seat 1: kalopara ($3.67 in chips) 
Seat 2: hugoreisssss ($4.86 in chips) 
Seat 3: Ingyeoking ($4.42 in chips) 
Seat 4: sepik200 ($5.02 in chips) 
Seat 5: zodapoker ($6.67 in chips) 
Seat 6: FakaN4Kavera ($5.75 in chips) 
hugoreisssss: posts small blind $0.02
Ingyeoking: posts big blind $0.05
*** HOLE CARDS ***
Dealt to FakaN4Kavera [Ac 7h]
sepik200: folds 
zodapoker: folds 
FakaN4Kavera: folds 
kalopara: folds 
hugoreisssss: folds 
Uncalled bet ($0.03) returned to Ingyeoking
Ingyeoking collected $0.04 from pot
Ingyeoking: doesn't show hand 
*** SUMMARY ***
Total pot $0.04 | Rake $0 
Seat 1: kalopara (button) folded before Flop (didn't bet)
Seat 2: hugoreisssss (small blind) folded before Flop
Seat 3: Ingyeoking (big blind) collected ($0.04)
Seat 4: sepik200 folded before Flop (didn't bet)
Seat 5: zodapoker folded before Flop (didn't bet)
Seat 6: FakaN4Kavera folded before Flop (didn't bet)



PokerStars Zoom Hand #257880003688:  Hold'em No Limit ($0.02/$0.05) - 2025/09/25 19:36:01 JST [2025/09/25 6:36:01 ET]
Table 'Donati' 6-max Seat #1 is the button
Seat 1: huyjokezy ($5 in chips) 
Seat 2: FakaN4Kavera ($5.77 in chips) 
Seat 3: kmc4444 ($5 in chips) 
Seat 4: KRSofM ($5.08 in chips) 
Seat 5: YAG5292 ($8.96 in chips) 
Seat 6: zodapoker ($6.67 in chips) 
FakaN4Kavera: posts small blind $0.02
kmc4444: posts big blind $0.05
*** HOLE CARDS ***
Dealt to FakaN4Kavera [7h 2s]
KRSofM: folds 
YAG5292: raises $0.09 to $0.14
zodapoker: folds 
huyjokezy: folds 
FakaN4Kavera: folds 
kmc4444: calls $0.09
*** FLOP *** [Ac 5d Kd]
kmc4444: checks 
YAG5292: bets $0.15
kmc4444: calls $0.15
*** TURN *** [Ac 5d Kd] [3d]
kmc4444: checks 
YAG5292: bets $0.29
kmc4444: raises $0.66 to $0.95
YAG5292: folds 
Uncalled bet ($0.66) returned to kmc4444
kmc4444 collected $1.13 from pot
kmc4444: doesn't show hand 
*** SUMMARY ***
Total pot $1.18 | Rake $0.05 
Board [Ac 5d Kd 3d]
Seat 1: huyjokezy (button) folded before Flop (didn't bet)
Seat 2: FakaN4Kavera (small blind) folded before Flop
Seat 3: kmc4444 (big blind) collected ($1.13)
Seat 4: KRSofM folded before Flop (didn't bet)
Seat 5: YAG5292 folded on the Turn
Seat 6: zodapoker folded before Flop (didn't bet)



PokerStars Zoom Hand #257880005317:  Hold'em No Limit ($0.02/$0.05) - 2025/09/25 19:36:18 JST [2025/09/25 6:36:18 ET]
Table 'Donati' 6-max Seat #1 is the button
Seat 1: FakaN4Kavera ($5.75 in chips) 
Seat 2: KRSofM ($5.08 in chips) 
Seat 3: huyjokezy ($5 in chips) 
Seat 4: 1Kronos ($10.31 in chips) 
Seat 5: ICallForYou ($4 in chips) 
Seat 6: gio119 ($5.07 in chips) 
KRSofM: posts small blind $0.02
huyjokezy: posts big blind $0.05
*** HOLE CARDS ***
Dealt to FakaN4Kavera [Qc 5c]
1Kronos: folds 
ICallForYou: folds 
gio119 has timed out
gio119: folds 
FakaN4Kavera: raises $0.07 to $0.12
KRSofM: folds 
huyjokezy: folds 
Uncalled bet ($0.07) returned to FakaN4Kavera
FakaN4Kavera collected $0.12 from pot
FakaN4Kavera: doesn't show hand 
*** SUMMARY ***
Total pot $0.12 | Rake $0 
Seat 1: FakaN4Kavera (button) collected ($0.12)
Seat 2: KRSofM (small blind) folded before Flop
Seat 3: huyjokezy (big blind) folded before Flop
Seat 4: 1Kronos folded before Flop (didn't bet)
Seat 5: ICallForYou folded before Flop (didn't bet)
Seat 6: gio119 folded before Flop (didn't bet)



PokerStars Zoom Hand #257880011811:  Hold'em No Limit ($0.02/$0.05) - 2025/09/25 19:37:23 JST [2025/09/25 6:37:23 ET]
Table 'Donati' 6-max Seat #1 is the button
Seat 1: lebifflemaster ($7.43 in chips) 
Seat 2: kalopara ($4.35 in chips) 
Seat 3: FakaN4Kavera ($5.82 in chips) 
Seat 4: tomis1312 ($5 in chips) 
Seat 5: 1Kronos ($16.16 in chips) 
Seat 6: IBRODIAN-ACER ($5 in chips) 
kalopara: posts small blind $0.02
FakaN4Kavera: posts big blind $0.05
*** HOLE CARDS ***
Dealt to FakaN4Kavera [4d 8d]
tomis1312: folds 
1Kronos: folds 
IBRODIAN-ACER: folds 
lebifflemaster: folds 
kalopara: raises $0.10 to $0.15
FakaN4Kavera: folds 
Uncalled bet ($0.10) returned to kalopara
kalopara collected $0.10 from pot
kalopara: doesn't show hand 
*** SUMMARY ***
Total pot $0.10 | Rake $0 
Seat 1: lebifflemaster (button) folded before Flop (didn't bet)
Seat 2: kalopara (small blind) collected ($0.10)
Seat 3: FakaN4Kavera (big blind) folded before Flop
Seat 4: tomis1312 folded before Flop (didn't bet)
Seat 5: 1Kronos folded before Flop (didn't bet)
Seat 6: IBRODIAN-ACER folded before Flop (didn't bet)



PokerStars Zoom Hand #257880011310:  Hold'em No Limit ($0.02/$0.05) - 2025/09/25 19:37:18 JST [2025/09/25 6:37:18 ET]
Table 'Donati' 6-max Seat #1 is the button
Seat 1: titeuf3012 ($4.93 in chips) 
Seat 2: intentii ($5.69 in chips) 
Seat 3: KRSofM ($5.03 in chips) 
Seat 4: FakaN4Kavera ($5.82 in chips) 
Seat 5: Ingyeoking ($10.11 in chips) 
Seat 6: zodapoker ($7.19 in chips) 
intentii: posts small blind $0.02
KRSofM: posts big blind $0.05
*** HOLE CARDS ***
Dealt to FakaN4Kavera [7d 4h]
FakaN4Kavera: folds 
Ingyeoking: folds 
zodapoker: folds 
titeuf3012: folds 
intentii: folds 
Uncalled bet ($0.03) returned to KRSofM
KRSofM collected $0.04 from pot
KRSofM: doesn't show hand 
*** SUMMARY ***
Total pot $0.04 | Rake $0 
Seat 1: titeuf3012 (button) folded before Flop (didn't bet)
Seat 2: intentii (small blind) folded before Flop
Seat 3: KRSofM (big blind) collected ($0.04)
Seat 4: FakaN4Kavera folded before Flop (didn't bet)
Seat 5: Ingyeoking folded before Flop (didn't bet)
Seat 6: zodapoker folded before Flop (didn't bet)



PokerStars Zoom Hand #257880012834:  Hold'em No Limit ($0.02/$0.05) - 2025/09/25 19:37:33 JST [2025/09/25 6:37:33 ET]
Table 'Donati' 6-max Seat #1 is the button
Seat 1: intentii ($5.81 in chips) 
Seat 2: kalopara ($10.55 in chips) 
Seat 3: KRSofM ($4.69 in chips) 
Seat 4: FakaN4Kavera ($5.77 in chips) 
Seat 5: Epist461 ($5 in chips) 
Seat 6: muhaaa3000 ($3.86 in chips) 
kalopara: posts small blind $0.02
KRSofM: posts big blind $0.05
*** HOLE CARDS ***
Dealt to FakaN4Kavera [4s Jh]
FakaN4Kavera: folds 
Epist461: folds 
muhaaa3000: raises $0.05 to $0.10
intentii: folds 
kalopara: folds 
KRSofM: folds 
Uncalled bet ($0.05) returned to muhaaa3000
muhaaa3000 collected $0.12 from pot
muhaaa3000: doesn't show hand 
*** SUMMARY ***
Total pot $0.12 | Rake $0 
Seat 1: intentii (button) folded before Flop (didn't bet)
Seat 2: kalopara (small blind) folded before Flop
Seat 3: KRSofM (big blind) folded before Flop
Seat 4: FakaN4Kavera folded before Flop (didn't bet)
Seat 5: Epist461 folded before Flop (didn't bet)
Seat 6: muhaaa3000 collected ($0.12)



PokerStars Zoom Hand #257880014783:  Hold'em No Limit ($0.02/$0.05) - 2025/09/25 19:37:53 JST [2025/09/25 6:37:53 ET]
Table 'Donati' 6-max Seat #1 is the button
Seat 1: FakaN4Kavera ($5.75 in chips) 
Seat 2: tomis1312 ($5 in chips) 
Seat 3: faithfulness ($5 in chips) 
Seat 4: intentii ($5.81 in chips) 
Seat 5: muhaaa3000 ($3.93 in chips) 
Seat 6: 1Kronos ($16.33 in chips) 
tomis1312: posts small blind $0.02
faithfulness: posts big blind $0.05
*** HOLE CARDS ***
Dealt to FakaN4Kavera [Js 7d]
intentii: folds 
muhaaa3000: folds 
1Kronos: folds 
FakaN4Kavera: folds 
tomis1312: raises $0.10 to $0.15
faithfulness: folds 
Uncalled bet ($0.10) returned to tomis1312
tomis1312 collected $0.10 from pot
tomis1312: doesn't show hand 
*** SUMMARY ***
Total pot $0.10 | Rake $0 
Seat 1: FakaN4Kavera (button) folded before Flop (didn't bet)
Seat 2: tomis1312 (small blind) collected ($0.10)
Seat 3: faithfulness (big blind) folded before Flop
Seat 4: intentii folded before Flop (didn't bet)
Seat 5: muhaaa3000 folded before Flop (didn't bet)
Seat 6: 1Kronos folded before Flop (didn't bet)



PokerStars Zoom Hand #257880015204:  Hold'em No Limit ($0.02/$0.05) - 2025/09/25 19:37:57 JST [2025/09/25 6:37:57 ET]
Table 'Donati' 6-max Seat #1 is the button
Seat 1: IBRODIAN-ACER ($5.07 in chips) 
Seat 2: KRSofM ($4.64 in chips) 
Seat 3: kalopara ($4.23 in chips) 
Seat 4: huyjokezy ($5.03 in chips) 
Seat 5: Megam181 ($3.07 in chips) 
Seat 6: FakaN4Kavera ($5.75 in chips) 
KRSofM: posts small blind $0.02
kalopara: posts big blind $0.05
*** HOLE CARDS ***
Dealt to FakaN4Kavera [4c 9c]
huyjokezy: raises $0.05 to $0.10
Megam181: folds 
FakaN4Kavera: folds 
IBRODIAN-ACER: folds 
KRSofM: raises $0.45 to $0.55
kalopara: folds 
huyjokezy: folds 
Uncalled bet ($0.45) returned to KRSofM
KRSofM collected $0.25 from pot
KRSofM: doesn't show hand 
*** SUMMARY ***
Total pot $0.25 | Rake $0 
Seat 1: IBRODIAN-ACER (button) folded before Flop (didn't bet)
Seat 2: KRSofM (small blind) collected ($0.25)
Seat 3: kalopara (big blind) folded before Flop
Seat 4: huyjokezy folded before Flop
Seat 5: Megam181 folded before Flop (didn't bet)
Seat 6: FakaN4Kavera folded before Flop (didn't bet)



PokerStars Zoom Hand #257880015950:  Hold'em No Limit ($0.02/$0.05) - 2025/09/25 19:38:04 JST [2025/09/25 6:38:04 ET]
Table 'Donati' 6-max Seat #1 is the button
Seat 1: kmc4444 ($6.51 in chips) 
Seat 2: scottie4barnes ($4.88 in chips) 
Seat 3: Baikasas ($6.09 in chips) 
Seat 4: KRSofM ($6.28 in chips) 
Seat 5: FakaN4Kavera ($5.75 in chips) 
Seat 6: IBRODIAN-ACER ($5.07 in chips) 
scottie4barnes: posts small blind $0.02
Baikasas: posts big blind $0.05
*** HOLE CARDS ***
Dealt to FakaN4Kavera [Kc 2d]
KRSofM: folds 
FakaN4Kavera: folds 
IBRODIAN-ACER: folds 
kmc4444: folds 
scottie4barnes: folds 
Uncalled bet ($0.03) returned to Baikasas
Baikasas collected $0.04 from pot
Baikasas: doesn't show hand 
*** SUMMARY ***
Total pot $0.04 | Rake $0 
Seat 1: kmc4444 (button) folded before Flop (didn't bet)
Seat 2: scottie4barnes (small blind) folded before Flop
Seat 3: Baikasas (big blind) collected ($0.04)
Seat 4: KRSofM folded before Flop (didn't bet)
Seat 5: FakaN4Kavera folded before Flop (didn't bet)
Seat 6: IBRODIAN-ACER folded before Flop (didn't bet)



PokerStars Zoom Hand #257880016344:  Hold'em No Limit ($0.02/$0.05) - 2025/09/25 19:38:08 JST [2025/09/25 6:38:08 ET]
Table 'Donati' 6-max Seat #1 is the button
Seat 1: kalopara ($4.18 in chips) 
Seat 2: Kenbunshoku ($3.70 in chips) 
Seat 3: elmex886 ($5.52 in chips) 
Seat 4: FakaN4Kavera ($5.75 in chips) 
Seat 5: IBRODIAN-ACER ($5.07 in chips) 
Seat 6: serg430606 ($5.73 in chips) 
Kenbunshoku: posts small blind $0.02
elmex886: posts big blind $0.05
*** HOLE CARDS ***
Dealt to FakaN4Kavera [Kh 4c]
FakaN4Kavera: folds 
IBRODIAN-ACER: folds 
serg430606: folds 
kalopara: raises $0.05 to $0.10
Kenbunshoku: folds 
elmex886: folds 
Uncalled bet ($0.05) returned to kalopara
kalopara collected $0.12 from pot
kalopara: doesn't show hand 
*** SUMMARY ***
Total pot $0.12 | Rake $0 
Seat 1: kalopara (button) collected ($0.12)
Seat 2: Kenbunshoku (small blind) folded before Flop
Seat 3: elmex886 (big blind) folded before Flop
Seat 4: FakaN4Kavera folded before Flop (didn't bet)
Seat 5: IBRODIAN-ACER folded before Flop (didn't bet)
Seat 6: serg430606 folded before Flop (didn't bet)



PokerStars Zoom Hand #257880016732:  Hold'em No Limit ($0.02/$0.05) - 2025/09/25 19:38:12 JST [2025/09/25 6:38:12 ET]
Table 'Donati' 6-max Seat #1 is the button
Seat 1: huyjokezy ($5 in chips) 
Seat 2: kmc4444 ($6.76 in chips) 
Seat 3: FakaN4Kavera ($5.75 in chips) 
Seat 4: IBRODIAN-ACER ($5.07 in chips) 
Seat 5: KRSofM ($5.03 in chips) 
Seat 6: faithfulness ($5.07 in chips) 
kmc4444: posts small blind $0.02
FakaN4Kavera: posts big blind $0.05
*** HOLE CARDS ***
Dealt to FakaN4Kavera [9d 4d]
IBRODIAN-ACER: raises $0.10 to $0.15
KRSofM: folds 
faithfulness: folds 
huyjokezy: folds 
kmc4444: folds 
FakaN4Kavera: folds 
Uncalled bet ($0.10) returned to IBRODIAN-ACER
IBRODIAN-ACER collected $0.12 from pot
IBRODIAN-ACER: doesn't show hand 
*** SUMMARY ***
Total pot $0.12 | Rake $0 
Seat 1: huyjokezy (button) folded before Flop (didn't bet)
Seat 2: kmc4444 (small blind) folded before Flop
Seat 3: FakaN4Kavera (big blind) folded before Flop
Seat 4: IBRODIAN-ACER collected ($0.12)
Seat 5: KRSofM folded before Flop (didn't bet)
Seat 6: faithfulness folded before Flop (didn't bet)



PokerStars Zoom Hand #257880013310:  Hold'em No Limit ($0.02/$0.05) - 2025/09/25 19:37:38 JST [2025/09/25 6:37:38 ET]
Table 'Donati' 6-max Seat #1 is the button
Seat 1: 1Kronos ($12.33 in chips) 
Seat 2: FakaN4Kavera ($5.77 in chips) 
Seat 3: titeuf3012 ($4.93 in chips) 
Seat 4: IBRODIAN-ACER ($5 in chips) 
Seat 5: YAG5292 ($5.28 in chips) 
Seat 6: zodapoker ($4.37 in chips) 
FakaN4Kavera: posts small blind $0.02
titeuf3012: posts big blind $0.05
*** HOLE CARDS ***
Dealt to FakaN4Kavera [Tc Jd]
IBRODIAN-ACER: folds 
YAG5292: folds 
zodapoker: folds 
1Kronos: raises $0.05 to $0.10
FakaN4Kavera: folds 
titeuf3012: raises $0.25 to $0.35
1Kronos: calls $0.25
*** FLOP *** [9d As 7c]
titeuf3012: bets $0.35
1Kronos: calls $0.35
*** TURN *** [9d As 7c] [2h]
titeuf3012: checks 
1Kronos: checks 
*** RIVER *** [9d As 7c 2h] [2d]
titeuf3012: checks 
1Kronos: checks 
*** SHOW DOWN ***
titeuf3012: shows [Kh Qh] (a pair of Deuces)
1Kronos: shows [7s 4s] (two pair, Sevens and Deuces)
1Kronos collected $1.36 from pot
*** SUMMARY ***
Total pot $1.42 | Rake $0.06 
Board [9d As 7c 2h 2d]
Seat 1: 1Kronos (button) showed [7s 4s] and won ($1.36) with two pair, Sevens and Deuces
Seat 2: FakaN4Kavera (small blind) folded before Flop
Seat 3: titeuf3012 (big blind) showed [Kh Qh] and lost with a pair of Deuces
Seat 4: IBRODIAN-ACER folded before Flop (didn't bet)
Seat 5: YAG5292 folded before Flop (didn't bet)
Seat 6: zodapoker folded before Flop (didn't bet)



PokerStars Zoom Hand #257880017236:  Hold'em No Limit ($0.02/$0.05) - 2025/09/25 19:38:17 JST [2025/09/25 6:38:17 ET]
Table 'Donati' 6-max Seat #1 is the button
Seat 1: Ingyeoking ($4.37 in chips) 
Seat 2: FakaN4Kavera ($5.70 in chips) 
Seat 3: huyjokezy ($5 in chips) 
Seat 4: semmely ($9.38 in chips) 
Seat 5: 1Kronos ($9.08 in chips) 
Seat 6: KRSofM ($5.03 in chips) 
FakaN4Kavera: posts small blind $0.02
huyjokezy: posts big blind $0.05
*** HOLE CARDS ***
Dealt to FakaN4Kavera [7s 6h]
semmely: folds 
1Kronos: raises $0.05 to $0.10
KRSofM: folds 
Ingyeoking: folds 
FakaN4Kavera: folds 
huyjokezy: folds 
Uncalled bet ($0.05) returned to 1Kronos
1Kronos collected $0.12 from pot
1Kronos: doesn't show hand 
*** SUMMARY ***
Total pot $0.12 | Rake $0 
Seat 1: Ingyeoking (button) folded before Flop (didn't bet)
Seat 2: FakaN4Kavera (small blind) folded before Flop
Seat 3: huyjokezy (big blind) folded before Flop
Seat 4: semmely folded before Flop (didn't bet)
Seat 5: 1Kronos collected ($0.12)
Seat 6: KRSofM folded before Flop (didn't bet)



PokerStars Zoom Hand #257880019395:  Hold'em No Limit ($0.02/$0.05) - 2025/09/25 19:38:39 JST [2025/09/25 6:38:39 ET]
Table 'Donati' 6-max Seat #1 is the button
Seat 1: DurandalMIA ($5.29 in chips) 
Seat 2: coolDadJimbo ($9.78 in chips) 
Seat 3: FakaN4Kavera ($5.68 in chips) 
Seat 4: semmely ($9.36 in chips) 
Seat 5: KRSofM ($6.21 in chips) 
Seat 6: zodapoker ($6.29 in chips) 
coolDadJimbo: posts small blind $0.02
FakaN4Kavera: posts big blind $0.05
*** HOLE CARDS ***
Dealt to FakaN4Kavera [Qs Ah]
semmely: folds 
KRSofM: folds 
zodapoker: folds 
DurandalMIA: folds 
coolDadJimbo: folds 
Uncalled bet ($0.03) returned to FakaN4Kavera
FakaN4Kavera collected $0.04 from pot
FakaN4Kavera: doesn't show hand 
*** SUMMARY ***
Total pot $0.04 | Rake $0 
Seat 1: DurandalMIA (button) folded before Flop (didn't bet)
Seat 2: coolDadJimbo (small blind) folded before Flop
Seat 3: FakaN4Kavera (big blind) collected ($0.04)
Seat 4: semmely folded before Flop (didn't bet)
Seat 5: KRSofM folded before Flop (didn't bet)
Seat 6: zodapoker folded before Flop (didn't bet)



PokerStars Zoom Hand #257880019101:  Hold'em No Limit ($0.02/$0.05) - 2025/09/25 19:38:36 JST [2025/09/25 6:38:36 ET]
Table 'Donati' 6-max Seat #1 is the button
Seat 1: intentii ($5.61 in chips) 
Seat 2: YAG5292 ($5.48 in chips) 
Seat 3: Baikasas ($5.14 in chips) 
Seat 4: huyjokezy ($5.51 in chips) 
Seat 5: kalopara ($4.25 in chips) 
Seat 6: FakaN4Kavera ($5.68 in chips) 
YAG5292: posts small blind $0.02
Baikasas: posts big blind $0.05
*** HOLE CARDS ***
Dealt to FakaN4Kavera [5s 7c]
huyjokezy: folds 
kalopara: folds 
FakaN4Kavera: folds 
intentii: raises $0.08 to $0.13
YAG5292: folds 
Baikasas: folds 
Uncalled bet ($0.08) returned to intentii
intentii collected $0.12 from pot
intentii: doesn't show hand 
*** SUMMARY ***
Total pot $0.12 | Rake $0 
Seat 1: intentii (button) collected ($0.12)
Seat 2: YAG5292 (small blind) folded before Flop
Seat 3: Baikasas (big blind) folded before Flop
Seat 4: huyjokezy folded before Flop (didn't bet)
Seat 5: kalopara folded before Flop (didn't bet)
Seat 6: FakaN4Kavera folded before Flop (didn't bet)



PokerStars Zoom Hand #257880020498:  Hold'em No Limit ($0.02/$0.05) - 2025/09/25 19:38:51 JST [2025/09/25 6:38:51 ET]
Table 'Donati' 6-max Seat #1 is the button
Seat 1: huyjokezy ($5 in chips) 
Seat 2: Miss Turbo G ($6.09 in chips) 
Seat 3: KRSofM ($5 in chips) 
Seat 4: FakaN4Kavera ($5.70 in chips) 
Seat 5: serg430606 ($5.48 in chips) 
Seat 6: kalopara ($4.13 in chips) 
Miss Turbo G: posts small blind $0.02
KRSofM: posts big blind $0.05
*** HOLE CARDS ***
Dealt to FakaN4Kavera [Ks 7c]
FakaN4Kavera: folds 
serg430606: folds 
kalopara: raises $0.07 to $0.12
huyjokezy: folds 
Miss Turbo G: folds 
KRSofM: folds 
Uncalled bet ($0.07) returned to kalopara
kalopara collected $0.12 from pot
kalopara: doesn't show hand 
*** SUMMARY ***
Total pot $0.12 | Rake $0 
Seat 1: huyjokezy (button) folded before Flop (didn't bet)
Seat 2: Miss Turbo G (small blind) folded before Flop
Seat 3: KRSofM (big blind) folded before Flop
Seat 4: FakaN4Kavera folded before Flop (didn't bet)
Seat 5: serg430606 folded before Flop (didn't bet)
Seat 6: kalopara collected ($0.12)



PokerStars Zoom Hand #257880020810:  Hold'em No Limit ($0.02/$0.05) - 2025/09/25 19:38:54 JST [2025/09/25 6:38:54 ET]
Table 'Donati' 6-max Seat #1 is the button
Seat 1: kalopara ($3.60 in chips) 
Seat 2: FakaN4Kavera ($5.70 in chips) 
Seat 3: DurandalMIA ($5.27 in chips) 
Seat 4: YAG5292 ($8.67 in chips) 
Seat 5: Kenzo2211 ($5.08 in chips) 
Seat 6: Baikasas ($6.11 in chips) 
FakaN4Kavera: posts small blind $0.02
DurandalMIA: posts big blind $0.05
*** HOLE CARDS ***
Dealt to FakaN4Kavera [9c Kh]
YAG5292: folds 
Kenzo2211: folds 
Baikasas: folds 
kalopara: folds 
FakaN4Kavera: folds 
Uncalled bet ($0.03) returned to DurandalMIA
DurandalMIA collected $0.04 from pot
DurandalMIA: doesn't show hand 
*** SUMMARY ***
Total pot $0.04 | Rake $0 
Seat 1: kalopara (button) folded before Flop (didn't bet)
Seat 2: FakaN4Kavera (small blind) folded before Flop
Seat 3: DurandalMIA (big blind) collected ($0.04)
Seat 4: YAG5292 folded before Flop (didn't bet)
Seat 5: Kenzo2211 folded before Flop (didn't bet)
Seat 6: Baikasas folded before Flop (didn't bet)



PokerStars Zoom Hand #257880018283:  Hold'em No Limit ($0.02/$0.05) - 2025/09/25 19:38:28 JST [2025/09/25 6:38:28 ET]
Table 'Donati' 6-max Seat #1 is the button
Seat 1: FakaN4Kavera ($5.68 in chips) 
Seat 2: IBRODIAN-ACER ($5.14 in chips) 
Seat 3: klevinjer ($5 in chips) 
Seat 4: kalopara ($10.21 in chips) 
Seat 5: coolDadJimbo ($5.39 in chips) 
Seat 6: muhaaa3000 ($3.93 in chips) 
IBRODIAN-ACER: posts small blind $0.02
klevinjer: posts big blind $0.05
*** HOLE CARDS ***
Dealt to FakaN4Kavera [2s Tc]
kalopara: folds 
coolDadJimbo: folds 
muhaaa3000: raises $0.10 to $0.15
FakaN4Kavera: folds 
IBRODIAN-ACER: folds 
klevinjer: calls $0.10
*** FLOP *** [3d Ts Th]
klevinjer: checks 
muhaaa3000: checks 
*** TURN *** [3d Ts Th] [7s]
klevinjer: checks 
muhaaa3000: checks 
*** RIVER *** [3d Ts Th 7s] [6h]
klevinjer: checks 
muhaaa3000: bets $0.31
klevinjer: folds 
Uncalled bet ($0.31) returned to muhaaa3000
muhaaa3000 collected $0.31 from pot
muhaaa3000: doesn't show hand 
*** SUMMARY ***
Total pot $0.32 | Rake $0.01 
Board [3d Ts Th 7s 6h]
Seat 1: FakaN4Kavera (button) folded before Flop (didn't bet)
Seat 2: IBRODIAN-ACER (small blind) folded before Flop
Seat 3: klevinjer (big blind) folded on the River
Seat 4: kalopara folded before Flop (didn't bet)
Seat 5: coolDadJimbo folded before Flop (didn't bet)
Seat 6: muhaaa3000 collected ($0.31)



PokerStars Zoom Hand #257880022138:  Hold'em No Limit ($0.02/$0.05) - 2025/09/25 19:39:07 JST [2025/09/25 6:39:07 ET]
Table 'Donati' 6-max Seat #1 is the button
Seat 1: semmely ($9.29 in chips) 
Seat 2: KRSofM ($5.13 in chips) 
Seat 3: coolDadJimbo ($5.63 in chips) 
Seat 4: alpaz01 ($5.65 in chips) 
Seat 5: FakaN4Kavera ($5.68 in chips) 
Seat 6: YAG5292 ($5.53 in chips) 
KRSofM: posts small blind $0.02
coolDadJimbo: posts big blind $0.05
*** HOLE CARDS ***
Dealt to FakaN4Kavera [Ks 3s]
alpaz01: folds 
FakaN4Kavera: folds 
YAG5292: folds 
semmely: folds 
KRSofM: raises $0.10 to $0.15
coolDadJimbo: folds 
Uncalled bet ($0.10) returned to KRSofM
KRSofM collected $0.10 from pot
KRSofM: doesn't show hand 
*** SUMMARY ***
Total pot $0.10 | Rake $0 
Seat 1: semmely (button) folded before Flop (didn't bet)
Seat 2: KRSofM (small blind) collected ($0.10)
Seat 3: coolDadJimbo (big blind) folded before Flop
Seat 4: alpaz01 folded before Flop (didn't bet)
Seat 5: FakaN4Kavera folded before Flop (didn't bet)
Seat 6: YAG5292 folded before Flop (didn't bet)



PokerStars Zoom Hand #257880022823:  Hold'em No Limit ($0.02/$0.05) - 2025/09/25 19:39:14 JST [2025/09/25 6:39:14 ET]
Table 'Donati' 6-max Seat #1 is the button
Seat 1: YAG5292 ($5.53 in chips) 
Seat 2: klevinjer ($4.85 in chips) 
Seat 3: Schöngeist71 ($12.44 in chips) 
Seat 4: FakaN4Kavera ($5.68 in chips) 
Seat 5: VXNX$157 ($2.52 in chips) 
Seat 6: egoor199 ($5.24 in chips) 
klevinjer: posts small blind $0.02
Schöngeist71: posts big blind $0.05
*** HOLE CARDS ***
Dealt to FakaN4Kavera [3d Qd]
FakaN4Kavera: folds 
VXNX$157: folds 
egoor199: folds 
YAG5292: folds 
klevinjer: folds 
Uncalled bet ($0.03) returned to Schöngeist71
Schöngeist71 collected $0.04 from pot
Schöngeist71: doesn't show hand 
*** SUMMARY ***
Total pot $0.04 | Rake $0 
Seat 1: YAG5292 (button) folded before Flop (didn't bet)
Seat 2: klevinjer (small blind) folded before Flop
Seat 3: Schöngeist71 (big blind) collected ($0.04)
Seat 4: FakaN4Kavera folded before Flop (didn't bet)
Seat 5: VXNX$157 folded before Flop (didn't bet)
Seat 6: egoor199 folded before Flop (didn't bet)



PokerStars Zoom Hand #257880017617:  Hold'em No Limit ($0.02/$0.05) - 2025/09/25 19:38:21 JST [2025/09/25 6:38:21 ET]
Table 'Donati' 6-max Seat #1 is the button
Seat 1: semmely ($9.38 in chips) 
Seat 2: elmex886 ($5.47 in chips) 
Seat 3: coolDadJimbo ($9.83 in chips) 
Seat 4: YAG5292 ($10.99 in chips) 
Seat 5: FakaN4Kavera ($5.68 in chips) 
Seat 6: intentii ($5.27 in chips) 
elmex886: posts small blind $0.02
coolDadJimbo: posts big blind $0.05
*** HOLE CARDS ***
Dealt to FakaN4Kavera [2c 7c]
YAG5292: folds 
FakaN4Kavera: folds 
intentii: raises $0.08 to $0.13
semmely: folds 
elmex886: calls $0.11
coolDadJimbo: folds 
*** FLOP *** [5h 4c 9c]
elmex886: checks 
intentii: bets $0.15
elmex886: calls $0.15
*** TURN *** [5h 4c 9c] [9h]
elmex886: checks 
intentii: checks 
*** RIVER *** [5h 4c 9c 9h] [5c]
elmex886: bets $0.19
intentii: calls $0.19
*** SHOW DOWN ***
elmex886: shows [9d Kd] (a full house, Nines full of Fives)
intentii: mucks hand 
elmex886 collected $0.95 from pot
*** SUMMARY ***
Total pot $0.99 | Rake $0.04 
Board [5h 4c 9c 9h 5c]
Seat 1: semmely (button) folded before Flop (didn't bet)
Seat 2: elmex886 (small blind) showed [9d Kd] and won ($0.95) with a full house, Nines full of Fives
Seat 3: coolDadJimbo (big blind) folded before Flop
Seat 4: YAG5292 folded before Flop (didn't bet)
Seat 5: FakaN4Kavera folded before Flop (didn't bet)
Seat 6: intentii mucked [Qd Qc]



PokerStars Zoom Hand #257880021325:  Hold'em No Limit ($0.02/$0.05) - 2025/09/25 19:38:59 JST [2025/09/25 6:38:59 ET]
Table 'Donati' 6-max Seat #1 is the button
Seat 1: Baikasas ($6.11 in chips) 
Seat 2: 1Kronos ($9.10 in chips) 
Seat 3: huyjokezy ($5 in chips) 
Seat 4: Kenzo2211 ($5.08 in chips) 
Seat 5: kalopara ($3.60 in chips) 
Seat 6: FakaN4Kavera ($5.68 in chips) 
1Kronos: posts small blind $0.02
huyjokezy: posts big blind $0.05
*** HOLE CARDS ***
Dealt to FakaN4Kavera [Td 7s]
Kenzo2211: folds 
kalopara: raises $0.07 to $0.12
FakaN4Kavera: folds 
Baikasas: folds 
1Kronos: raises $0.43 to $0.55
huyjokezy: folds 
kalopara: raises $3.05 to $3.60 and is all-in
1Kronos: calls $3.05
*** FLOP *** [9h 8h Jd]
*** TURN *** [9h 8h Jd] [Kd]
*** RIVER *** [9h 8h Jd Kd] [4s]
*** SHOW DOWN ***
1Kronos: shows [As Ks] (a pair of Kings)
kalopara: shows [Kh Kc] (three of a kind, Kings)
kalopara collected $6.95 from pot
*** SUMMARY ***
Total pot $7.25 | Rake $0.30 
Board [9h 8h Jd Kd 4s]
Seat 1: Baikasas (button) folded before Flop (didn't bet)
Seat 2: 1Kronos (small blind) showed [As Ks] and lost with a pair of Kings
Seat 3: huyjokezy (big blind) folded before Flop
Seat 4: Kenzo2211 folded before Flop (didn't bet)
Seat 5: kalopara showed [Kh Kc] and won ($6.95) with three of a kind, Kings
Seat 6: FakaN4Kavera folded before Flop (didn't bet)



PokerStars Zoom Hand #257880023113:  Hold'em No Limit ($0.02/$0.05) - 2025/09/25 19:39:17 JST [2025/09/25 6:39:17 ET]
Table 'Donati' 6-max Seat #1 is the button
Seat 1: coolDadJimbo ($9.83 in chips) 
Seat 2: skygger777 ($5.02 in chips) 
Seat 3: FakaN4Kavera ($5.68 in chips) 
Seat 4: huyjokezy ($6.01 in chips) 
Seat 5: kalopara ($4.22 in chips) 
Seat 6: Baikasas ($5.09 in chips) 
skygger777: posts small blind $0.02
FakaN4Kavera: posts big blind $0.05
*** HOLE CARDS ***
Dealt to FakaN4Kavera [Th Js]
huyjokezy: raises $0.10 to $0.15
kalopara: folds 
Baikasas: folds 
coolDadJimbo: folds 
skygger777: calls $0.13
FakaN4Kavera: folds 
*** FLOP *** [9c 8c 2c]
skygger777: checks 
huyjokezy: checks 
*** TURN *** [9c 8c 2c] [4s]
skygger777: bets $0.10
huyjokezy: calls $0.10
*** RIVER *** [9c 8c 2c 4s] [As]
skygger777: bets $0.55
huyjokezy: folds 
Uncalled bet ($0.55) returned to skygger777
skygger777 collected $0.53 from pot
skygger777: doesn't show hand 
*** SUMMARY ***
Total pot $0.55 | Rake $0.02 
Board [9c 8c 2c 4s As]
Seat 1: coolDadJimbo (button) folded before Flop (didn't bet)
Seat 2: skygger777 (small blind) collected ($0.53)
Seat 3: FakaN4Kavera (big blind) folded before Flop
Seat 4: huyjokezy folded on the River
Seat 5: kalopara folded before Flop (didn't bet)
Seat 6: Baikasas folded before Flop (didn't bet)



PokerStars Zoom Hand #257880022505:  Hold'em No Limit ($0.02/$0.05) - 2025/09/25 19:39:10 JST [2025/09/25 6:39:10 ET]
Table 'Donati' 6-max Seat #1 is the button
Seat 1: FakaN4Kavera ($5.68 in chips) 
Seat 2: Baikasas ($6.11 in chips) 
Seat 3: alpaz01 ($5.65 in chips) 
Seat 4: IBRODIAN-ACER ($5.14 in chips) 
Seat 5: kalopara ($10.14 in chips) 
Seat 6: semmely ($9.29 in chips) 
Baikasas: posts small blind $0.02
alpaz01: posts big blind $0.05
*** HOLE CARDS ***
Dealt to FakaN4Kavera [9d 3h]
IBRODIAN-ACER: folds 
kalopara: folds 
semmely: folds 
FakaN4Kavera: folds 
Baikasas: raises $0.10 to $0.15
alpaz01: raises $0.30 to $0.45
Baikasas: calls $0.30
*** FLOP *** [Jd 9c 2d]
Baikasas: checks 
alpaz01: bets $0.63
Baikasas: calls $0.63
*** TURN *** [Jd 9c 2d] [4d]
Baikasas: checks 
alpaz01: checks 
*** RIVER *** [Jd 9c 2d 4d] [5c]
Baikasas: bets $0.75
alpaz01: raises $1.79 to $2.54
Baikasas: folds 
Uncalled bet ($1.79) returned to alpaz01
alpaz01 collected $3.51 from pot
alpaz01: doesn't show hand 
*** SUMMARY ***
Total pot $3.66 | Rake $0.15 
Board [Jd 9c 2d 4d 5c]
Seat 1: FakaN4Kavera (button) folded before Flop (didn't bet)
Seat 2: Baikasas (small blind) folded on the River
Seat 3: alpaz01 (big blind) collected ($3.51)
Seat 4: IBRODIAN-ACER folded before Flop (didn't bet)
Seat 5: kalopara folded before Flop (didn't bet)
Seat 6: semmely folded before Flop (didn't bet)



PokerStars Zoom Hand #257880024798:  Hold'em No Limit ($0.02/$0.05) - 2025/09/25 19:39:34 JST [2025/09/25 6:39:34 ET]
Table 'Donati' 6-max Seat #1 is the button
Seat 1: IBRODIAN-ACER ($5 in chips) 
Seat 2: FakaN4Kavera ($5.63 in chips) 
Seat 3: Kenzo2211 ($5.11 in chips) 
Seat 4: huyjokezy ($5.51 in chips) 
Seat 5: egoor199 ($6.32 in chips) 
Seat 6: coolDadJimbo ($9.83 in chips) 
FakaN4Kavera: posts small blind $0.02
Kenzo2211: posts big blind $0.05
*** HOLE CARDS ***
Dealt to FakaN4Kavera [3d 3s]
huyjokezy: folds 
egoor199: raises $0.05 to $0.10
coolDadJimbo: folds 
IBRODIAN-ACER: folds 
FakaN4Kavera: calls $0.08
Kenzo2211: calls $0.05
*** FLOP *** [Kc 6h 2s]
FakaN4Kavera: checks 
Kenzo2211: checks 
egoor199: bets $0.07
FakaN4Kavera: folds 
Kenzo2211: folds 
Uncalled bet ($0.07) returned to egoor199
egoor199 collected $0.29 from pot
egoor199: doesn't show hand 
*** SUMMARY ***
Total pot $0.30 | Rake $0.01 
Board [Kc 6h 2s]
Seat 1: IBRODIAN-ACER (button) folded before Flop (didn't bet)
Seat 2: FakaN4Kavera (small blind) folded on the Flop
Seat 3: Kenzo2211 (big blind) folded on the Flop
Seat 4: huyjokezy folded before Flop (didn't bet)
Seat 5: egoor199 collected ($0.29)
Seat 6: coolDadJimbo folded before Flop (didn't bet)



PokerStars Zoom Hand #257880028905:  Hold'em No Limit ($0.02/$0.05) - 2025/09/25 19:40:14 JST [2025/09/25 6:40:14 ET]
Table 'Donati' 6-max Seat #1 is the button
Seat 1: FakaN4Kavera ($5.53 in chips) 
Seat 2: zodapoker ($7.53 in chips) 
Seat 3: YAG5292 ($2.35 in chips) 
Seat 4: goaßmaß-fips ($14.30 in chips) 
Seat 5: intentii ($5.75 in chips) 
Seat 6: DurandalMIA ($3.50 in chips) 
zodapoker: posts small blind $0.02
YAG5292: posts big blind $0.05
*** HOLE CARDS ***
Dealt to FakaN4Kavera [7d As]
goaßmaß-fips: folds 
intentii: raises $0.08 to $0.13
DurandalMIA: calls $0.13
FakaN4Kavera: folds 
zodapoker: folds 
YAG5292: folds 
*** FLOP *** [6c 8s 9c]
intentii: checks 
DurandalMIA: bets $0.05
intentii: raises $0.25 to $0.30
DurandalMIA: folds 
Uncalled bet ($0.25) returned to intentii
intentii collected $0.41 from pot
intentii: doesn't show hand 
*** SUMMARY ***
Total pot $0.43 | Rake $0.02 
Board [6c 8s 9c]
Seat 1: FakaN4Kavera (button) folded before Flop (didn't bet)
Seat 2: zodapoker (small blind) folded before Flop
Seat 3: YAG5292 (big blind) folded before Flop
Seat 4: goaßmaß-fips folded before Flop (didn't bet)
Seat 5: intentii collected ($0.41)
Seat 6: DurandalMIA folded on the Flop



PokerStars Zoom Hand #257880032620:  Hold'em No Limit ($0.02/$0.05) - 2025/09/25 19:40:50 JST [2025/09/25 6:40:50 ET]
Table 'Donati' 6-max Seat #1 is the button
Seat 1: FakaN4Kavera ($5.48 in chips) 
Seat 2: faithfulness ($5.21 in chips) 
Seat 3: sepik200 ($4.60 in chips) 
Seat 4: kalopara ($4.41 in chips) 
Seat 5: Epist461 ($5.88 in chips) 
Seat 6: alpaz01 ($7.38 in chips) 
faithfulness: posts small blind $0.02
sepik200: posts big blind $0.05
*** HOLE CARDS ***
Dealt to FakaN4Kavera [7c 5d]
kalopara: folds 
Epist461: folds 
alpaz01: folds 
FakaN4Kavera: folds 
faithfulness: raises $0.10 to $0.15
sepik200: folds 
Uncalled bet ($0.10) returned to faithfulness
faithfulness collected $0.10 from pot
faithfulness: doesn't show hand 
*** SUMMARY ***
Total pot $0.10 | Rake $0 
Seat 1: FakaN4Kavera (button) folded before Flop (didn't bet)
Seat 2: faithfulness (small blind) collected ($0.10)
Seat 3: sepik200 (big blind) folded before Flop
Seat 4: kalopara folded before Flop (didn't bet)
Seat 5: Epist461 folded before Flop (didn't bet)
Seat 6: alpaz01 folded before Flop (didn't bet)



PokerStars Zoom Hand #257880030746:  Hold'em No Limit ($0.02/$0.05) - 2025/09/25 19:40:32 JST [2025/09/25 6:40:32 ET]
Table 'Donati' 6-max Seat #1 is the button
Seat 1: leakleakA ($12.90 in chips) 
Seat 2: huyjokezy ($5.36 in chips) 
Seat 3: FakaN4Kavera ($5.53 in chips) 
Seat 4: TTPP92 ($5.34 in chips) 
Seat 5: 1Kronos ($5.52 in chips) 
Seat 6: Kenzo2211 ($5 in chips) 
huyjokezy: posts small blind $0.02
FakaN4Kavera: posts big blind $0.05
*** HOLE CARDS ***
Dealt to FakaN4Kavera [9d 2d]
TTPP92: raises $0.05 to $0.10
1Kronos: raises $0.28 to $0.38
Kenzo2211: folds 
leakleakA: folds 
huyjokezy: folds 
FakaN4Kavera: folds 
TTPP92: raises $4.96 to $5.34 and is all-in
1Kronos: folds 
Uncalled bet ($4.96) returned to TTPP92
TTPP92 collected $0.83 from pot
TTPP92: doesn't show hand 
*** SUMMARY ***
Total pot $0.83 | Rake $0 
Seat 1: leakleakA (button) folded before Flop (didn't bet)
Seat 2: huyjokezy (small blind) folded before Flop
Seat 3: FakaN4Kavera (big blind) folded before Flop
Seat 4: TTPP92 collected ($0.83)
Seat 5: 1Kronos folded before Flop
Seat 6: Kenzo2211 folded before Flop (didn't bet)



PokerStars Zoom Hand #257880033018:  Hold'em No Limit ($0.02/$0.05) - 2025/09/25 19:40:54 JST [2025/09/25 6:40:54 ET]
Table 'Donati' 6-max Seat #1 is the button
Seat 1: KRSofM ($5.95 in chips) 
Seat 2: FakaN4Kavera ($5.48 in chips) 
Seat 3: IBRODIAN-ACER ($5.07 in chips) 
Seat 4: alpaz01 ($7.38 in chips) 
Seat 5: 1Kronos ($12.73 in chips) 
Seat 6: tomis1312 ($5 in chips) 
FakaN4Kavera: posts small blind $0.02
IBRODIAN-ACER: posts big blind $0.05
*** HOLE CARDS ***
Dealt to FakaN4Kavera [2d Ac]
alpaz01: folds 
1Kronos: folds 
tomis1312: folds 
KRSofM: raises $0.07 to $0.12
FakaN4Kavera: folds 
IBRODIAN-ACER: folds 
Uncalled bet ($0.07) returned to KRSofM
KRSofM collected $0.12 from pot
KRSofM: doesn't show hand 
*** SUMMARY ***
Total pot $0.12 | Rake $0 
Seat 1: KRSofM (button) collected ($0.12)
Seat 2: FakaN4Kavera (small blind) folded before Flop
Seat 3: IBRODIAN-ACER (big blind) folded before Flop
Seat 4: alpaz01 folded before Flop (didn't bet)
Seat 5: 1Kronos folded before Flop (didn't bet)
Seat 6: tomis1312 folded before Flop (didn't bet)



PokerStars Zoom Hand #257880033425:  Hold'em No Limit ($0.02/$0.05) - 2025/09/25 19:40:58 JST [2025/09/25 6:40:58 ET]
Table 'Donati' 6-max Seat #1 is the button
Seat 1: elmex886 ($5.90 in chips) 
Seat 2: faithfulness ($5.37 in chips) 
Seat 3: huyjokezy ($5.34 in chips) 
Seat 4: zodapoker ($7.39 in chips) 
Seat 5: Vasco4430 ($9.78 in chips) 
Seat 6: FakaN4Kavera ($5.46 in chips) 
faithfulness: posts small blind $0.02
huyjokezy: posts big blind $0.05
*** HOLE CARDS ***
Dealt to FakaN4Kavera [7c 6h]
zodapoker: folds 
Vasco4430: raises $0.10 to $0.15
FakaN4Kavera: folds 
elmex886: folds 
faithfulness: folds 
huyjokezy: folds 
Uncalled bet ($0.10) returned to Vasco4430
Vasco4430 collected $0.12 from pot
Vasco4430: doesn't show hand 
*** SUMMARY ***
Total pot $0.12 | Rake $0 
Seat 1: elmex886 (button) folded before Flop (didn't bet)
Seat 2: faithfulness (small blind) folded before Flop
Seat 3: huyjokezy (big blind) folded before Flop
Seat 4: zodapoker folded before Flop (didn't bet)
Seat 5: Vasco4430 collected ($0.12)
Seat 6: FakaN4Kavera folded before Flop (didn't bet)



PokerStars Zoom Hand #257880033954:  Hold'em No Limit ($0.02/$0.05) - 2025/09/25 19:41:03 JST [2025/09/25 6:41:03 ET]
Table 'Donati' 6-max Seat #1 is the button
Seat 1: Baikasas ($5 in chips) 
Seat 2: scottie4barnes ($3.80 in chips) 
Seat 3: Epist461 ($5.88 in chips) 
Seat 4: skygger777 ($5.55 in chips) 
Seat 5: FakaN4Kavera ($5.46 in chips) 
Seat 6: serg430606 ($5.13 in chips) 
scottie4barnes: posts small blind $0.02
Epist461: posts big blind $0.05
*** HOLE CARDS ***
Dealt to FakaN4Kavera [8d 4s]
skygger777: folds 
FakaN4Kavera: folds 
serg430606: raises $0.10 to $0.15
Baikasas: folds 
scottie4barnes: calls $0.13
Epist461: folds 
*** FLOP *** [6h 2d Ts]
scottie4barnes: checks 
serg430606: bets $0.17
scottie4barnes: folds 
Uncalled bet ($0.17) returned to serg430606
serg430606 collected $0.34 from pot
serg430606: doesn't show hand 
*** SUMMARY ***
Total pot $0.35 | Rake $0.01 
Board [6h 2d Ts]
Seat 1: Baikasas (button) folded before Flop (didn't bet)
Seat 2: scottie4barnes (small blind) folded on the Flop
Seat 3: Epist461 (big blind) folded before Flop
Seat 4: skygger777 folded before Flop (didn't bet)
Seat 5: FakaN4Kavera folded before Flop (didn't bet)
Seat 6: serg430606 collected ($0.34)



PokerStars Zoom Hand #257880034347:  Hold'em No Limit ($0.02/$0.05) - 2025/09/25 19:41:07 JST [2025/09/25 6:41:07 ET]
Table 'Donati' 6-max Seat #1 is the button
Seat 1: zodapoker ($8.21 in chips) 
Seat 2: tomis1312 ($5 in chips) 
Seat 3: Ingyeoking ($4.51 in chips) 
Seat 4: FakaN4Kavera ($5.46 in chips) 
Seat 5: egoor199 ($5.62 in chips) 
Seat 6: 1Kronos ($5.14 in chips) 
tomis1312: posts small blind $0.02
Ingyeoking: posts big blind $0.05
*** HOLE CARDS ***
Dealt to FakaN4Kavera [6c Ts]
FakaN4Kavera: folds 
egoor199: folds 
1Kronos: folds 
zodapoker: raises $0.07 to $0.12
tomis1312: raises $0.39 to $0.51
Ingyeoking: folds 
zodapoker: folds 
Uncalled bet ($0.39) returned to tomis1312
tomis1312 collected $0.29 from pot
tomis1312: doesn't show hand 
*** SUMMARY ***
Total pot $0.29 | Rake $0 
Seat 1: zodapoker (button) folded before Flop
Seat 2: tomis1312 (small blind) collected ($0.29)
Seat 3: Ingyeoking (big blind) folded before Flop
Seat 4: FakaN4Kavera folded before Flop (didn't bet)
Seat 5: egoor199 folded before Flop (didn't bet)
Seat 6: 1Kronos folded before Flop (didn't bet)



PokerStars Zoom Hand #257880034738:  Hold'em No Limit ($0.02/$0.05) - 2025/09/25 19:41:11 JST [2025/09/25 6:41:11 ET]
Table 'Donati' 6-max Seat #1 is the button
Seat 1: KRSofM ($4.95 in chips) 
Seat 2: elmex886 ($5.90 in chips) 
Seat 3: FakaN4Kavera ($5.46 in chips) 
Seat 4: Ingyeoking ($5.15 in chips) 
Seat 5: zodapoker ($6.51 in chips) 
Seat 6: IBRODIAN-ACER ($5 in chips) 
elmex886: posts small blind $0.02
FakaN4Kavera: posts big blind $0.05
*** HOLE CARDS ***
Dealt to FakaN4Kavera [3h As]
Ingyeoking: folds 
zodapoker: folds 
IBRODIAN-ACER: calls $0.05
KRSofM: folds 
elmex886: folds 
FakaN4Kavera: checks 
*** FLOP *** [9s 7h 8d]
FakaN4Kavera: checks 
IBRODIAN-ACER: checks 
*** TURN *** [9s 7h 8d] [Qd]
FakaN4Kavera: checks 
IBRODIAN-ACER: bets $0.06
FakaN4Kavera: folds 
Uncalled bet ($0.06) returned to IBRODIAN-ACER
IBRODIAN-ACER collected $0.12 from pot
IBRODIAN-ACER: doesn't show hand 
*** SUMMARY ***
Total pot $0.12 | Rake $0 
Board [9s 7h 8d Qd]
Seat 1: KRSofM (button) folded before Flop (didn't bet)
Seat 2: elmex886 (small blind) folded before Flop
Seat 3: FakaN4Kavera (big blind) folded on the Turn
Seat 4: Ingyeoking folded before Flop (didn't bet)
Seat 5: zodapoker folded before Flop (didn't bet)
Seat 6: IBRODIAN-ACER collected ($0.12)



PokerStars Zoom Hand #257880030110:  Hold'em No Limit ($0.02/$0.05) - 2025/09/25 19:40:26 JST [2025/09/25 6:40:26 ET]
Table 'Donati' 6-max Seat #1 is the button
Seat 1: KRSofM ($5.09 in chips) 
Seat 2: Kenbunshoku ($4.46 in chips) 
Seat 3: GabsGoty ($2.62 in chips) 
Seat 4: Ingyeoking ($5.02 in chips) 
Seat 5: delfinato200 ($13.87 in chips) 
Seat 6: FakaN4Kavera ($5.53 in chips) 
Kenbunshoku: posts small blind $0.02
GabsGoty: posts big blind $0.05
*** HOLE CARDS ***
Dealt to FakaN4Kavera [6h 4s]
Ingyeoking: folds 
delfinato200: folds 
FakaN4Kavera: folds 
KRSofM: raises $0.07 to $0.12
Kenbunshoku: raises $0.29 to $0.41
GabsGoty: calls $0.36
KRSofM: calls $0.29
*** FLOP *** [Kh Qd 4h]
Kenbunshoku: bets $0.39
GabsGoty: folds 
KRSofM: calls $0.39
*** TURN *** [Kh Qd 4h] [Jc]
Kenbunshoku: bets $1.30
KRSofM: raises $2.99 to $4.29 and is all-in
Kenbunshoku: calls $2.36 and is all-in
Uncalled bet ($0.63) returned to KRSofM
*** RIVER *** [Kh Qd 4h Jc] [8d]
*** SHOW DOWN ***
Kenbunshoku: shows [Tc Ad] (a straight, Ten to Ace)
KRSofM: shows [2h Ah] (high card Ace)
Kenbunshoku collected $8.94 from pot
*** SUMMARY ***
Total pot $9.33 | Rake $0.39 
Board [Kh Qd 4h Jc 8d]
Seat 1: KRSofM (button) showed [2h Ah] and lost with high card Ace
Seat 2: Kenbunshoku (small blind) showed [Tc Ad] and won ($8.94) with a straight, Ten to Ace
Seat 3: GabsGoty (big blind) folded on the Flop
Seat 4: Ingyeoking folded before Flop (didn't bet)
Seat 5: delfinato200 folded before Flop (didn't bet)
Seat 6: FakaN4Kavera folded before Flop (didn't bet)



PokerStars Zoom Hand #257880031341:  Hold'em No Limit ($0.02/$0.05) - 2025/09/25 19:40:38 JST [2025/09/25 6:40:38 ET]
Table 'Donati' 6-max Seat #1 is the button
Seat 1: kmc4444 ($5.07 in chips) 
Seat 2: YAG5292 ($2.30 in chips) 
Seat 3: Kenzo2211 ($5 in chips) 
Seat 4: intentii ($5 in chips) 
Seat 5: FakaN4Kavera ($5.48 in chips) 
Seat 6: sepik200 ($4.62 in chips) 
YAG5292: posts small blind $0.02
Kenzo2211: posts big blind $0.05
*** HOLE CARDS ***
Dealt to FakaN4Kavera [2h 9h]
intentii: folds 
FakaN4Kavera: folds 
sepik200: folds 
kmc4444: raises $0.07 to $0.12
YAG5292: folds 
Kenzo2211: calls $0.07
*** FLOP *** [7c Ah 7d]
Kenzo2211: checks 
kmc4444: bets $0.08
Kenzo2211: calls $0.08
*** TURN *** [7c Ah 7d] [Jc]
Kenzo2211: checks 
kmc4444: checks 
*** RIVER *** [7c Ah 7d Jc] [As]
Kenzo2211: checks 
kmc4444: bets $0.50
Kenzo2211: folds 
Uncalled bet ($0.50) returned to kmc4444
kmc4444 collected $0.40 from pot
kmc4444: doesn't show hand 
*** SUMMARY ***
Total pot $0.42 | Rake $0.02 
Board [7c Ah 7d Jc As]
Seat 1: kmc4444 (button) collected ($0.40)
Seat 2: YAG5292 (small blind) folded before Flop
Seat 3: Kenzo2211 (big blind) folded on the River
Seat 4: intentii folded before Flop (didn't bet)
Seat 5: FakaN4Kavera folded before Flop (didn't bet)
Seat 6: sepik200 folded before Flop (didn't bet)



PokerStars Zoom Hand #257880038953:  Hold'em No Limit ($0.02/$0.05) - 2025/09/25 19:41:51 JST [2025/09/25 6:41:51 ET]
Table 'Donati' 6-max Seat #1 is the button
Seat 1: serg430606 ($5.46 in chips) 
Seat 2: IBRODIAN-ACER ($5.07 in chips) 
Seat 3: lefra9 ($5 in chips) 
Seat 4: huyjokezy ($5.35 in chips) 
Seat 5: FakaN4Kavera ($5.41 in chips) 
Seat 6: Ingyeoking ($4.95 in chips) 
IBRODIAN-ACER: posts small blind $0.02
lefra9: posts big blind $0.05
*** HOLE CARDS ***
Dealt to FakaN4Kavera [Qh 8h]
huyjokezy: folds 
FakaN4Kavera: folds 
Ingyeoking: folds 
serg430606: folds 
IBRODIAN-ACER: folds 
Uncalled bet ($0.03) returned to lefra9
lefra9 collected $0.04 from pot
lefra9: doesn't show hand 
*** SUMMARY ***
Total pot $0.04 | Rake $0 
Seat 1: serg430606 (button) folded before Flop (didn't bet)
Seat 2: IBRODIAN-ACER (small blind) folded before Flop
Seat 3: lefra9 (big blind) collected ($0.04)
Seat 4: huyjokezy folded before Flop (didn't bet)
Seat 5: FakaN4Kavera folded before Flop (didn't bet)
Seat 6: Ingyeoking folded before Flop (didn't bet)



PokerStars Zoom Hand #257880039924:  Hold'em No Limit ($0.02/$0.05) - 2025/09/25 19:42:00 JST [2025/09/25 6:42:00 ET]
Table 'Donati' 6-max Seat #1 is the button
Seat 1: goaßmaß-fips ($14.23 in chips) 
Seat 2: faithfulness ($5.49 in chips) 
Seat 3: huyjokezy ($5 in chips) 
Seat 4: kmc4444 ($5.27 in chips) 
Seat 5: KRSofM ($4.90 in chips) 
Seat 6: FakaN4Kavera ($5.41 in chips) 
faithfulness: posts small blind $0.02
huyjokezy: posts big blind $0.05
*** HOLE CARDS ***
Dealt to FakaN4Kavera [8h Ah]
kmc4444: folds 
KRSofM: folds 
FakaN4Kavera: raises $0.07 to $0.12
goaßmaß-fips: folds 
faithfulness: folds 
huyjokezy: folds 
Uncalled bet ($0.07) returned to FakaN4Kavera
FakaN4Kavera collected $0.12 from pot
FakaN4Kavera: doesn't show hand 
*** SUMMARY ***
Total pot $0.12 | Rake $0 
Seat 1: goaßmaß-fips (button) folded before Flop (didn't bet)
Seat 2: faithfulness (small blind) folded before Flop
Seat 3: huyjokezy (big blind) folded before Flop
Seat 4: kmc4444 folded before Flop (didn't bet)
Seat 5: KRSofM folded before Flop (didn't bet)
Seat 6: FakaN4Kavera collected ($0.12)



PokerStars Zoom Hand #257880041590:  Hold'em No Limit ($0.02/$0.05) - 2025/09/25 19:42:16 JST [2025/09/25 6:42:16 ET]
Table 'Donati' 6-max Seat #1 is the button
Seat 1: FakaN4Kavera ($5.48 in chips) 
Seat 2: YAG5292 ($4.91 in chips) 
Seat 3: egoor199 ($5.71 in chips) 
Seat 4: IBRODIAN-ACER ($5.25 in chips) 
Seat 5: Kenzo2211 ($5.05 in chips) 
Seat 6: sepik200 ($4.33 in chips) 
YAG5292: posts small blind $0.02
egoor199: posts big blind $0.05
*** HOLE CARDS ***
Dealt to FakaN4Kavera [Th Td]
IBRODIAN-ACER: folds 
Kenzo2211: folds 
sepik200: folds 
FakaN4Kavera: raises $0.07 to $0.12
YAG5292: folds 
egoor199: folds 
Uncalled bet ($0.07) returned to FakaN4Kavera
FakaN4Kavera collected $0.12 from pot
FakaN4Kavera: doesn't show hand 
*** SUMMARY ***
Total pot $0.12 | Rake $0 
Seat 1: FakaN4Kavera (button) collected ($0.12)
Seat 2: YAG5292 (small blind) folded before Flop
Seat 3: egoor199 (big blind) folded before Flop
Seat 4: IBRODIAN-ACER folded before Flop (didn't bet)
Seat 5: Kenzo2211 folded before Flop (didn't bet)
Seat 6: sepik200 folded before Flop (didn't bet)



PokerStars Zoom Hand #257880044183:  Hold'em No Limit ($0.02/$0.05) - 2025/09/25 19:42:41 JST [2025/09/25 6:42:41 ET]
Table 'Donati' 6-max Seat #1 is the button
Seat 1: egoor199 ($5.66 in chips) 
Seat 2: FakaN4Kavera ($5.55 in chips) 
Seat 3: Baikasas ($5 in chips) 
Seat 4: KRSofM ($5.99 in chips) 
Seat 5: lefra9 ($5 in chips) 
Seat 6: Kenbunshoku ($8.94 in chips) 
FakaN4Kavera: posts small blind $0.02
Baikasas: posts big blind $0.05
*** HOLE CARDS ***
Dealt to FakaN4Kavera [5c Ts]
KRSofM: folds 
lefra9: folds 
Kenbunshoku: folds 
egoor199: folds 
FakaN4Kavera: folds 
Uncalled bet ($0.03) returned to Baikasas
Baikasas collected $0.04 from pot
Baikasas: doesn't show hand 
*** SUMMARY ***
Total pot $0.04 | Rake $0 
Seat 1: egoor199 (button) folded before Flop (didn't bet)
Seat 2: FakaN4Kavera (small blind) folded before Flop
Seat 3: Baikasas (big blind) collected ($0.04)
Seat 4: KRSofM folded before Flop (didn't bet)
Seat 5: lefra9 folded before Flop (didn't bet)
Seat 6: Kenbunshoku folded before Flop (didn't bet)



PokerStars Zoom Hand #257880045100:  Hold'em No Limit ($0.02/$0.05) - 2025/09/25 19:42:50 JST [2025/09/25 6:42:50 ET]
Table 'Donati' 6-max Seat #1 is the button
Seat 1: Ingyeoking ($6.23 in chips) 
Seat 2: KRSofM ($4.93 in chips) 
Seat 3: IBRODIAN-ACER ($5.21 in chips) 
Seat 4: kalopara ($9.25 in chips) 
Seat 5: zodapoker ($8.33 in chips) 
Seat 6: FakaN4Kavera ($5.53 in chips) 
KRSofM: posts small blind $0.02
IBRODIAN-ACER: posts big blind $0.05
*** HOLE CARDS ***
Dealt to FakaN4Kavera [Kc 9c]
kalopara: folds 
zodapoker: folds 
FakaN4Kavera: raises $0.07 to $0.12
Ingyeoking: folds 
KRSofM: folds 
IBRODIAN-ACER: calls $0.07
*** FLOP *** [3h Kd Js]
IBRODIAN-ACER: checks 
FakaN4Kavera: bets $0.13
IBRODIAN-ACER: calls $0.13
*** TURN *** [3h Kd Js] [9h]
IBRODIAN-ACER: checks 
FakaN4Kavera: bets $0.25
IBRODIAN-ACER: folds 
Uncalled bet ($0.25) returned to FakaN4Kavera
FakaN4Kavera collected $0.50 from pot
FakaN4Kavera: doesn't show hand 
*** SUMMARY ***
Total pot $0.52 | Rake $0.02 
Board [3h Kd Js 9h]
Seat 1: Ingyeoking (button) folded before Flop (didn't bet)
Seat 2: KRSofM (small blind) folded before Flop
Seat 3: IBRODIAN-ACER (big blind) folded on the Turn
Seat 4: kalopara folded before Flop (didn't bet)
Seat 5: zodapoker folded before Flop (didn't bet)
Seat 6: FakaN4Kavera collected ($0.50)



PokerStars Zoom Hand #257880049153:  Hold'em No Limit ($0.02/$0.05) - 2025/09/25 19:43:30 JST [2025/09/25 6:43:30 ET]
Table 'Donati' 6-max Seat #1 is the button
Seat 1: Ingyeoking ($6.16 in chips) 
Seat 2: faithfulness ($5.14 in chips) 
Seat 3: lefra9 ($5.20 in chips) 
Seat 4: FakaN4Kavera ($5.78 in chips) 
Seat 5: Schöngeist71 ($11.09 in chips) 
Seat 6: Epist461 ($6.31 in chips) 
faithfulness: posts small blind $0.02
lefra9: posts big blind $0.05
*** HOLE CARDS ***
Dealt to FakaN4Kavera [Kc 3h]
FakaN4Kavera: folds 
Schöngeist71: raises $0.10 to $0.15
Epist461: folds 
Ingyeoking: folds 
faithfulness: folds 
lefra9: folds 
Uncalled bet ($0.10) returned to Schöngeist71
Schöngeist71 collected $0.12 from pot
Schöngeist71: doesn't show hand 
*** SUMMARY ***
Total pot $0.12 | Rake $0 
Seat 1: Ingyeoking (button) folded before Flop (didn't bet)
Seat 2: faithfulness (small blind) folded before Flop
Seat 3: lefra9 (big blind) folded before Flop
Seat 4: FakaN4Kavera folded before Flop (didn't bet)
Seat 5: Schöngeist71 collected ($0.12)
Seat 6: Epist461 folded before Flop (didn't bet)



PokerStars Zoom Hand #257880049680:  Hold'em No Limit ($0.02/$0.05) - 2025/09/25 19:43:35 JST [2025/09/25 6:43:35 ET]
Table 'Donati' 6-max Seat #1 is the button
Seat 1: Kenzo2211 ($5 in chips) 
Seat 2: FakaN4Kavera ($5.78 in chips) 
Seat 3: KRSofM ($4.69 in chips) 
Seat 4: 1Kronos ($14.30 in chips) 
Seat 5: egoor199 ($6.37 in chips) 
Seat 6: zodapoker ($6.66 in chips) 
FakaN4Kavera: posts small blind $0.02
KRSofM: posts big blind $0.05
*** HOLE CARDS ***
Dealt to FakaN4Kavera [Ts Jd]
1Kronos: folds 
egoor199: folds 
zodapoker: folds 
Kenzo2211: raises $0.05 to $0.10
FakaN4Kavera: folds 
KRSofM: raises $0.40 to $0.50
Kenzo2211: folds 
Uncalled bet ($0.40) returned to KRSofM
KRSofM collected $0.22 from pot
KRSofM: doesn't show hand 
*** SUMMARY ***
Total pot $0.22 | Rake $0 
Seat 1: Kenzo2211 (button) folded before Flop
Seat 2: FakaN4Kavera (small blind) folded before Flop
Seat 3: KRSofM (big blind) collected ($0.22)
Seat 4: 1Kronos folded before Flop (didn't bet)
Seat 5: egoor199 folded before Flop (didn't bet)
Seat 6: zodapoker folded before Flop (didn't bet)



PokerStars Zoom Hand #257880050096:  Hold'em No Limit ($0.02/$0.05) - 2025/09/25 19:43:39 JST [2025/09/25 6:43:39 ET]
Table 'Donati' 6-max Seat #1 is the button
Seat 1: faithfulness ($5.12 in chips) 
Seat 2: scottie4barnes ($3.26 in chips) 
Seat 3: FakaN4Kavera ($5.76 in chips) 
Seat 4: Ingyeoking ($4.41 in chips) 
Seat 5: tomis1312 ($5.30 in chips) 
Seat 6: PlonKa1980 ($3.82 in chips) 
scottie4barnes: posts small blind $0.02
FakaN4Kavera: posts big blind $0.05
*** HOLE CARDS ***
Dealt to FakaN4Kavera [Qs 7s]
Ingyeoking: folds 
tomis1312: folds 
PlonKa1980: folds 
faithfulness: raises $0.07 to $0.12
scottie4barnes: calls $0.10
FakaN4Kavera: folds 
*** FLOP *** [Ac 3h 4c]
scottie4barnes: bets $0.15
faithfulness: folds 
Uncalled bet ($0.15) returned to scottie4barnes
scottie4barnes collected $0.28 from pot
scottie4barnes: doesn't show hand 
*** SUMMARY ***
Total pot $0.29 | Rake $0.01 
Board [Ac 3h 4c]
Seat 1: faithfulness (button) folded on the Flop
Seat 2: scottie4barnes (small blind) collected ($0.28)
Seat 3: FakaN4Kavera (big blind) folded before Flop
Seat 4: Ingyeoking folded before Flop (didn't bet)
Seat 5: tomis1312 folded before Flop (didn't bet)
Seat 6: PlonKa1980 folded before Flop (didn't bet)



PokerStars Zoom Hand #257880051760:  Hold'em No Limit ($0.02/$0.05) - 2025/09/25 19:43:55 JST [2025/09/25 6:43:55 ET]
Table 'Donati' 6-max Seat #1 is the button
Seat 1: YAG5292 ($12.60 in chips) 
Seat 2: skygger777 ($5.02 in chips) 
Seat 3: egoor199 ($5.71 in chips) 
Seat 4: Ingyeoking ($4.36 in chips) 
Seat 5: FakaN4Kavera ($5.71 in chips) 
Seat 6: Brun077a ($4.42 in chips) 
skygger777: posts small blind $0.02
egoor199: posts big blind $0.05
*** HOLE CARDS ***
Dealt to FakaN4Kavera [Jd 7d]
Ingyeoking: folds 
FakaN4Kavera: folds 
Brun077a: calls $0.05
YAG5292: folds 
skygger777: raises $0.10 to $0.15
egoor199: folds 
Brun077a: calls $0.10
*** FLOP *** [5s 7h Qs]
skygger777: checks 
Brun077a: bets $0.10
skygger777: folds 
Uncalled bet ($0.10) returned to Brun077a
Brun077a collected $0.34 from pot
Brun077a: doesn't show hand 
*** SUMMARY ***
Total pot $0.35 | Rake $0.01 
Board [5s 7h Qs]
Seat 1: YAG5292 (button) folded before Flop (didn't bet)
Seat 2: skygger777 (small blind) folded on the Flop
Seat 3: egoor199 (big blind) folded before Flop
Seat 4: Ingyeoking folded before Flop (didn't bet)
Seat 5: FakaN4Kavera folded before Flop (didn't bet)
Seat 6: Brun077a collected ($0.34)



PokerStars Zoom Hand #257880052604:  Hold'em No Limit ($0.02/$0.05) - 2025/09/25 19:44:03 JST [2025/09/25 6:44:03 ET]
Table 'Donati' 6-max Seat #1 is the button
Seat 1: intentii ($5 in chips) 
Seat 2: KRSofM ($4.83 in chips) 
Seat 3: cherry006 ($3.77 in chips) 
Seat 4: FakaN4Kavera ($5.71 in chips) 
Seat 5: muhaaa3000 ($3.98 in chips) 
Seat 6: faithfulness ($5 in chips) 
KRSofM: posts small blind $0.02
cherry006: posts big blind $0.05
*** HOLE CARDS ***
Dealt to FakaN4Kavera [3d Ts]
FakaN4Kavera: folds 
muhaaa3000: folds 
faithfulness: folds 
intentii: raises $0.08 to $0.13
KRSofM: folds 
cherry006: folds 
Uncalled bet ($0.08) returned to intentii
intentii collected $0.12 from pot
intentii: doesn't show hand 
*** SUMMARY ***
Total pot $0.12 | Rake $0 
Seat 1: intentii (button) collected ($0.12)
Seat 2: KRSofM (small blind) folded before Flop
Seat 3: cherry006 (big blind) folded before Flop
Seat 4: FakaN4Kavera folded before Flop (didn't bet)
Seat 5: muhaaa3000 folded before Flop (didn't bet)
Seat 6: faithfulness folded before Flop (didn't bet)



PokerStars Zoom Hand #257880053535:  Hold'em No Limit ($0.02/$0.05) - 2025/09/25 19:44:12 JST [2025/09/25 6:44:12 ET]
Table 'Donati' 6-max Seat #1 is the button
Seat 1: zodapoker ($6.73 in chips) 
Seat 2: 1Kronos ($14.25 in chips) 
Seat 3: FakaN4Kavera ($5.71 in chips) 
Seat 4: muhaaa3000 ($3.98 in chips) 
Seat 5: ICallForYou ($4.34 in chips) 
Seat 6: KRSofM ($4.79 in chips) 
1Kronos: posts small blind $0.02
FakaN4Kavera: posts big blind $0.05
*** HOLE CARDS ***
Dealt to FakaN4Kavera [Qc Ts]
muhaaa3000: raises $0.05 to $0.10
ICallForYou: folds 
KRSofM: folds 
zodapoker: folds 
1Kronos: folds 
FakaN4Kavera: folds 
Uncalled bet ($0.05) returned to muhaaa3000
muhaaa3000 collected $0.12 from pot
muhaaa3000: doesn't show hand 
*** SUMMARY ***
Total pot $0.12 | Rake $0 
Seat 1: zodapoker (button) folded before Flop (didn't bet)
Seat 2: 1Kronos (small blind) folded before Flop
Seat 3: FakaN4Kavera (big blind) folded before Flop
Seat 4: muhaaa3000 collected ($0.12)
Seat 5: ICallForYou folded before Flop (didn't bet)
Seat 6: KRSofM folded before Flop (didn't bet)



PokerStars Zoom Hand #257880051349:  Hold'em No Limit ($0.02/$0.05) - 2025/09/25 19:43:51 JST [2025/09/25 6:43:51 ET]
Table 'Donati' 6-max Seat #1 is the button
Seat 1: FakaN4Kavera ($5.71 in chips) 
Seat 2: 1Kronos ($15.26 in chips) 
Seat 3: sv5555555 ($4.48 in chips) 
Seat 4: skygger777 ($5.02 in chips) 
Seat 5: leakleakA ($11.80 in chips) 
Seat 6: Miss Turbo G ($7.11 in chips) 
1Kronos: posts small blind $0.02
sv5555555: posts big blind $0.05
*** HOLE CARDS ***
Dealt to FakaN4Kavera [4s 9h]
skygger777: folds 
leakleakA: folds 
Miss Turbo G: folds 
FakaN4Kavera: folds 
1Kronos: raises $0.10 to $0.15
sv5555555: calls $0.10
*** FLOP *** [9c 8s Qd]
1Kronos: bets $0.10
sv5555555: calls $0.10
*** TURN *** [9c 8s Qd] [Jh]
1Kronos: checks 
sv5555555: bets $0.24
1Kronos: calls $0.24
*** RIVER *** [9c 8s Qd Jh] [Ac]
1Kronos: bets $0.48
sv5555555: folds 
Uncalled bet ($0.48) returned to 1Kronos
1Kronos collected $0.94 from pot
1Kronos: doesn't show hand 
*** SUMMARY ***
Total pot $0.98 | Rake $0.04 
Board [9c 8s Qd Jh Ac]
Seat 1: FakaN4Kavera (button) folded before Flop (didn't bet)
Seat 2: 1Kronos (small blind) collected ($0.94)
Seat 3: sv5555555 (big blind) folded on the River
Seat 4: skygger777 folded before Flop (didn't bet)
Seat 5: leakleakA folded before Flop (didn't bet)
Seat 6: Miss Turbo G folded before Flop (didn't bet)



PokerStars Zoom Hand #257880054184:  Hold'em No Limit ($0.02/$0.05) - 2025/09/25 19:44:18 JST [2025/09/25 6:44:18 ET]
Table 'Donati' 6-max Seat #1 is the button
Seat 1: kmc4444 ($5.31 in chips) 
Seat 2: leakleakA ($11.87 in chips) 
Seat 3: faithfulness ($5 in chips) 
Seat 4: scottie4barnes ($3.42 in chips) 
Seat 5: Miss Turbo G ($7.04 in chips) 
Seat 6: FakaN4Kavera ($5.66 in chips) 
leakleakA: posts small blind $0.02
faithfulness: posts big blind $0.05
*** HOLE CARDS ***
Dealt to FakaN4Kavera [Qc 2h]
scottie4barnes: raises $0.10 to $0.15
Miss Turbo G: folds 
FakaN4Kavera: folds 
kmc4444: folds 
leakleakA: folds 
faithfulness: folds 
Uncalled bet ($0.10) returned to scottie4barnes
scottie4barnes collected $0.12 from pot
scottie4barnes: doesn't show hand 
*** SUMMARY ***
Total pot $0.12 | Rake $0 
Seat 1: kmc4444 (button) folded before Flop (didn't bet)
Seat 2: leakleakA (small blind) folded before Flop
Seat 3: faithfulness (big blind) folded before Flop
Seat 4: scottie4barnes collected ($0.12)
Seat 5: Miss Turbo G folded before Flop (didn't bet)
Seat 6: FakaN4Kavera folded before Flop (didn't bet)



PokerStars Zoom Hand #257880053115:  Hold'em No Limit ($0.02/$0.05) - 2025/09/25 19:44:08 JST [2025/09/25 6:44:08 ET]
Table 'Donati' 6-max Seat #1 is the button
Seat 1: Ingyeoking ($6.11 in chips) 
Seat 2: IBRODIAN-ACER ($5.02 in chips) 
Seat 3: JamesTiernan09 ($5 in chips) 
Seat 4: zodapoker ($6.73 in chips) 
Seat 5: faithfulness ($5 in chips) 
Seat 6: FakaN4Kavera ($5.71 in chips) 
IBRODIAN-ACER: posts small blind $0.02
JamesTiernan09: posts big blind $0.05
*** HOLE CARDS ***
Dealt to FakaN4Kavera [Qs 3s]
zodapoker: folds 
faithfulness: folds 
FakaN4Kavera: folds 
Ingyeoking: folds 
IBRODIAN-ACER: raises $0.10 to $0.15
JamesTiernan09: calls $0.10
*** FLOP *** [Ac 8h 6d]
IBRODIAN-ACER: checks 
JamesTiernan09: checks 
*** TURN *** [Ac 8h 6d] [5d]
IBRODIAN-ACER: checks 
JamesTiernan09: checks 
*** RIVER *** [Ac 8h 6d 5d] [Ad]
IBRODIAN-ACER: bets $0.20
JamesTiernan09: folds 
Uncalled bet ($0.20) returned to IBRODIAN-ACER
IBRODIAN-ACER collected $0.29 from pot
IBRODIAN-ACER: doesn't show hand 
*** SUMMARY ***
Total pot $0.30 | Rake $0.01 
Board [Ac 8h 6d 5d Ad]
Seat 1: Ingyeoking (button) folded before Flop (didn't bet)
Seat 2: IBRODIAN-ACER (small blind) collected ($0.29)
Seat 3: JamesTiernan09 (big blind) folded on the River
Seat 4: zodapoker folded before Flop (didn't bet)
Seat 5: faithfulness folded before Flop (didn't bet)
Seat 6: FakaN4Kavera folded before Flop (didn't bet)



PokerStars Zoom Hand #257880054714:  Hold'em No Limit ($0.02/$0.05) - 2025/09/25 19:44:23 JST [2025/09/25 6:44:23 ET]
Table 'Donati' 6-max Seat #1 is the button
Seat 1: kmc4444 ($5.11 in chips) 
Seat 2: FakaN4Kavera ($5.66 in chips) 
Seat 3: huyjokezy ($5.07 in chips) 
Seat 4: tomis1312 ($5.60 in chips) 
Seat 5: klevinjer ($5.38 in chips) 
Seat 6: IBRODIAN-ACER ($5 in chips) 
FakaN4Kavera: posts small blind $0.02
huyjokezy: posts big blind $0.05
*** HOLE CARDS ***
Dealt to FakaN4Kavera [Jh 3c]
tomis1312: folds 
klevinjer: raises $0.07 to $0.12
IBRODIAN-ACER: folds 
kmc4444: folds 
FakaN4Kavera: folds 
huyjokezy: folds 
Uncalled bet ($0.07) returned to klevinjer
klevinjer collected $0.12 from pot
klevinjer: doesn't show hand 
*** SUMMARY ***
Total pot $0.12 | Rake $0 
Seat 1: kmc4444 (button) folded before Flop (didn't bet)
Seat 2: FakaN4Kavera (small blind) folded before Flop
Seat 3: huyjokezy (big blind) folded before Flop
Seat 4: tomis1312 folded before Flop (didn't bet)
Seat 5: klevinjer collected ($0.12)
Seat 6: IBRODIAN-ACER folded before Flop (didn't bet)



PokerStars Zoom Hand #257880056389:  Hold'em No Limit ($0.02/$0.05) - 2025/09/25 19:44:40 JST [2025/09/25 6:44:40 ET]
Table 'Donati' 6-max Seat #1 is the button
Seat 1: faithfulness ($5 in chips) 
Seat 2: Kenzo2211 ($5 in chips) 
Seat 3: YAG5292 ($3.38 in chips) 
Seat 4: lefra9 ($5.20 in chips) 
Seat 5: FakaN4Kavera ($5.64 in chips) 
Seat 6: zodapoker ($8.19 in chips) 
Kenzo2211: posts small blind $0.02
YAG5292: posts big blind $0.05
*** HOLE CARDS ***
Dealt to FakaN4Kavera [5h 4d]
lefra9: folds 
FakaN4Kavera: folds 
zodapoker: folds 
faithfulness: raises $0.07 to $0.12
Kenzo2211: folds 
YAG5292: folds 
Uncalled bet ($0.07) returned to faithfulness
faithfulness collected $0.12 from pot
faithfulness: doesn't show hand 
*** SUMMARY ***
Total pot $0.12 | Rake $0 
Seat 1: faithfulness (button) collected ($0.12)
Seat 2: Kenzo2211 (small blind) folded before Flop
Seat 3: YAG5292 (big blind) folded before Flop
Seat 4: lefra9 folded before Flop (didn't bet)
Seat 5: FakaN4Kavera folded before Flop (didn't bet)
Seat 6: zodapoker folded before Flop (didn't bet)



PokerStars Zoom Hand #257880055535:  Hold'em No Limit ($0.02/$0.05) - 2025/09/25 19:44:31 JST [2025/09/25 6:44:31 ET]
Table 'Donati' 6-max Seat #1 is the button
Seat 1: FakaN4Kavera ($5.64 in chips) 
Seat 2: faithfulness ($5 in chips) 
Seat 3: YAG5292 ($3.94 in chips) 
Seat 4: Ingyeoking ($4.98 in chips) 
Seat 5: Kenzo2211 ($5.85 in chips) 
Seat 6: elmex886 ($5.44 in chips) 
faithfulness: posts small blind $0.02
YAG5292: posts big blind $0.05
*** HOLE CARDS ***
Dealt to FakaN4Kavera [8h 3h]
Ingyeoking: raises $0.05 to $0.10
Kenzo2211: folds 
elmex886: calls $0.10
FakaN4Kavera: folds 
faithfulness: folds 
YAG5292: raises $0.25 to $0.35
Ingyeoking: raises $0.60 to $0.95
elmex886: folds 
YAG5292: folds 
Uncalled bet ($0.60) returned to Ingyeoking
Ingyeoking collected $0.82 from pot
Ingyeoking: doesn't show hand 
*** SUMMARY ***
Total pot $0.82 | Rake $0 
Seat 1: FakaN4Kavera (button) folded before Flop (didn't bet)
Seat 2: faithfulness (small blind) folded before Flop
Seat 3: YAG5292 (big blind) folded before Flop
Seat 4: Ingyeoking collected ($0.82)
Seat 5: Kenzo2211 folded before Flop (didn't bet)
Seat 6: elmex886 folded before Flop



PokerStars Zoom Hand #257880057029:  Hold'em No Limit ($0.02/$0.05) - 2025/09/25 19:44:46 JST [2025/09/25 6:44:46 ET]
Table 'Donati' 6-max Seat #1 is the button
Seat 1: huyjokezy ($10.22 in chips) 
Seat 2: JamesTiernan09 ($4.85 in chips) 
Seat 3: FakaN4Kavera ($5.64 in chips) 
Seat 4: Kenzo2211 ($5.85 in chips) 
Seat 5: faithfulness ($5.05 in chips) 
Seat 6: intentii ($5.05 in chips) 
JamesTiernan09: posts small blind $0.02
FakaN4Kavera: posts big blind $0.05
*** HOLE CARDS ***
Dealt to FakaN4Kavera [9s 3c]
Kenzo2211: folds 
faithfulness: folds 
intentii: raises $0.08 to $0.13
huyjokezy: folds 
JamesTiernan09: folds 
FakaN4Kavera: folds 
Uncalled bet ($0.08) returned to intentii
intentii collected $0.12 from pot
intentii: doesn't show hand 
*** SUMMARY ***
Total pot $0.12 | Rake $0 
Seat 1: huyjokezy (button) folded before Flop (didn't bet)
Seat 2: JamesTiernan09 (small blind) folded before Flop
Seat 3: FakaN4Kavera (big blind) folded before Flop
Seat 4: Kenzo2211 folded before Flop (didn't bet)
Seat 5: faithfulness folded before Flop (didn't bet)
Seat 6: intentii collected ($0.12)



PokerStars Zoom Hand #257880059305:  Hold'em No Limit ($0.02/$0.05) - 2025/09/25 19:45:08 JST [2025/09/25 6:45:08 ET]
Table 'Donati' 6-max Seat #1 is the button
Seat 1: IBRODIAN-ACER ($5 in chips) 
Seat 2: FakaN4Kavera ($5.59 in chips) 
Seat 3: cherry006 ($3.75 in chips) 
Seat 4: leakleakA ($11.73 in chips) 
Seat 5: egoor199 ($5.22 in chips) 
Seat 6: 1Kronos ($10.04 in chips) 
FakaN4Kavera: posts small blind $0.02
cherry006: posts big blind $0.05
*** HOLE CARDS ***
Dealt to FakaN4Kavera [5d 6c]
leakleakA: folds 
egoor199: folds 
1Kronos: folds 
IBRODIAN-ACER: folds 
FakaN4Kavera: folds 
Uncalled bet ($0.03) returned to cherry006
cherry006 collected $0.04 from pot
cherry006: doesn't show hand 
*** SUMMARY ***
Total pot $0.04 | Rake $0 
Seat 1: IBRODIAN-ACER (button) folded before Flop (didn't bet)
Seat 2: FakaN4Kavera (small blind) folded before Flop
Seat 3: cherry006 (big blind) collected ($0.04)
Seat 4: leakleakA folded before Flop (didn't bet)
Seat 5: egoor199 folded before Flop (didn't bet)
Seat 6: 1Kronos folded before Flop (didn't bet)



PokerStars Zoom Hand #257880058609:  Hold'em No Limit ($0.02/$0.05) - 2025/09/25 19:45:01 JST [2025/09/25 6:45:01 ET]
Table 'Donati' 6-max Seat #1 is the button
Seat 1: klevinjer ($5.47 in chips) 
Seat 2: Epist461 ($6.14 in chips) 
Seat 3: sv5555555 ($3.97 in chips) 
Seat 4: FakaN4Kavera ($5.59 in chips) 
Seat 5: huyjokezy ($10.22 in chips) 
Seat 6: lefra9 ($5.15 in chips) 
Epist461: posts small blind $0.02
sv5555555: posts big blind $0.05
*** HOLE CARDS ***
Dealt to FakaN4Kavera [3s 5c]
FakaN4Kavera: folds 
huyjokezy: folds 
lefra9: raises $0.10 to $0.15
klevinjer: folds 
Epist461: raises $0.45 to $0.60
sv5555555: folds 
lefra9: folds 
Uncalled bet ($0.45) returned to Epist461
Epist461 collected $0.35 from pot
Epist461: doesn't show hand 
*** SUMMARY ***
Total pot $0.35 | Rake $0 
Seat 1: klevinjer (button) folded before Flop (didn't bet)
Seat 2: Epist461 (small blind) collected ($0.35)
Seat 3: sv5555555 (big blind) folded before Flop
Seat 4: FakaN4Kavera folded before Flop (didn't bet)
Seat 5: huyjokezy folded before Flop (didn't bet)
Seat 6: lefra9 folded before Flop



PokerStars Zoom Hand #257880060113:  Hold'em No Limit ($0.02/$0.05) - 2025/09/25 19:45:16 JST [2025/09/25 6:45:16 ET]
Table 'Donati' 6-max Seat #1 is the button
Seat 1: sv5555555 ($3.90 in chips) 
Seat 2: YAG5292 ($3.59 in chips) 
Seat 3: intentii ($5.07 in chips) 
Seat 4: FakaN4Kavera ($5.57 in chips) 
Seat 5: Baikasas ($5 in chips) 
Seat 6: semmely ($9.52 in chips) 
YAG5292: posts small blind $0.02
intentii: posts big blind $0.05
*** HOLE CARDS ***
Dealt to FakaN4Kavera [8c 9h]
FakaN4Kavera: folds 
Baikasas: folds 
semmely: folds 
sv5555555: folds 
YAG5292: folds 
Uncalled bet ($0.03) returned to intentii
intentii collected $0.04 from pot
intentii: doesn't show hand 
*** SUMMARY ***
Total pot $0.04 | Rake $0 
Seat 1: sv5555555 (button) folded before Flop (didn't bet)
Seat 2: YAG5292 (small blind) folded before Flop
Seat 3: intentii (big blind) collected ($0.04)
Seat 4: FakaN4Kavera folded before Flop (didn't bet)
Seat 5: Baikasas folded before Flop (didn't bet)
Seat 6: semmely folded before Flop (didn't bet)



PokerStars Zoom Hand #257880060660:  Hold'em No Limit ($0.02/$0.05) - 2025/09/25 19:45:21 JST [2025/09/25 6:45:21 ET]
Table 'Donati' 6-max Seat #1 is the button
Seat 1: FakaN4Kavera ($5.57 in chips) 
Seat 2: Ingyeoking ($5.40 in chips) 
Seat 3: YAG5292 ($12.09 in chips) 
Seat 4: semmely ($9.52 in chips) 
Seat 5: Miss Turbo G ($6.97 in chips) 
Seat 6: sv5555555 ($3.90 in chips) 
Ingyeoking: posts small blind $0.02
YAG5292: posts big blind $0.05
*** HOLE CARDS ***
Dealt to FakaN4Kavera [Ts 3s]
semmely: raises $0.05 to $0.10
Miss Turbo G: folds 
sv5555555: folds 
FakaN4Kavera: folds 
Ingyeoking: folds 
YAG5292: raises $0.17 to $0.27
semmely: folds 
Uncalled bet ($0.17) returned to YAG5292
YAG5292 collected $0.22 from pot
YAG5292: doesn't show hand 
*** SUMMARY ***
Total pot $0.22 | Rake $0 
Seat 1: FakaN4Kavera (button) folded before Flop (didn't bet)
Seat 2: Ingyeoking (small blind) folded before Flop
Seat 3: YAG5292 (big blind) collected ($0.22)
Seat 4: semmely folded before Flop
Seat 5: Miss Turbo G folded before Flop (didn't bet)
Seat 6: sv5555555 folded before Flop (didn't bet)



PokerStars Zoom Hand #257880061476:  Hold'em No Limit ($0.02/$0.05) - 2025/09/25 19:45:29 JST [2025/09/25 6:45:29 ET]
Table 'Donati' 6-max Seat #1 is the button
Seat 1: 1Kronos ($10.04 in chips) 
Seat 2: Ingyeoking ($10.91 in chips) 
Seat 3: FakaN4Kavera ($5.57 in chips) 
Seat 4: cherry006 ($3.77 in chips) 
Seat 5: franks270 ($12.28 in chips) 
Seat 6: Miss Turbo G ($6.97 in chips) 
Ingyeoking: posts small blind $0.02
FakaN4Kavera: posts big blind $0.05
*** HOLE CARDS ***
Dealt to FakaN4Kavera [3d Jh]
cherry006: folds 
franks270: folds 
Miss Turbo G: folds 
1Kronos: raises $0.05 to $0.10
Ingyeoking: folds 
FakaN4Kavera: folds 
Uncalled bet ($0.05) returned to 1Kronos
1Kronos collected $0.12 from pot
1Kronos: doesn't show hand 
*** SUMMARY ***
Total pot $0.12 | Rake $0 
Seat 1: 1Kronos (button) collected ($0.12)
Seat 2: Ingyeoking (small blind) folded before Flop
Seat 3: FakaN4Kavera (big blind) folded before Flop
Seat 4: cherry006 folded before Flop (didn't bet)
Seat 5: franks270 folded before Flop (didn't bet)
Seat 6: Miss Turbo G folded before Flop (didn't bet)



PokerStars Zoom Hand #257880061182:  Hold'em No Limit ($0.02/$0.05) - 2025/09/25 19:45:26 JST [2025/09/25 6:45:26 ET]
Table 'Donati' 6-max Seat #1 is the button
Seat 1: muhaaa3000 ($3.63 in chips) 
Seat 2: Schöngeist71 ($11.69 in chips) 
Seat 3: KRSofM ($5 in chips) 
Seat 4: Baikasas ($5 in chips) 
Seat 5: huyjokezy ($10.20 in chips) 
Seat 6: FakaN4Kavera ($5.57 in chips) 
Schöngeist71: posts small blind $0.02
KRSofM: posts big blind $0.05
*** HOLE CARDS ***
Dealt to FakaN4Kavera [5s 4h]
Baikasas: folds 
huyjokezy: folds 
FakaN4Kavera: folds 
muhaaa3000: folds 
Schöngeist71: raises $0.10 to $0.15
KRSofM: raises $0.30 to $0.45
Schöngeist71: calls $0.30
*** FLOP *** [5h 7c Ad]
Schöngeist71: checks 
KRSofM: bets $0.22
Schöngeist71: raises $0.48 to $0.70
KRSofM: folds 
Uncalled bet ($0.48) returned to Schöngeist71
Schöngeist71 collected $1.26 from pot
Schöngeist71: doesn't show hand 
*** SUMMARY ***
Total pot $1.34 | Rake $0.08 
Board [5h 7c Ad]
Seat 1: muhaaa3000 (button) folded before Flop (didn't bet)
Seat 2: Schöngeist71 (small blind) collected ($1.26)
Seat 3: KRSofM (big blind) folded on the Flop
Seat 4: Baikasas folded before Flop (didn't bet)
Seat 5: huyjokezy folded before Flop (didn't bet)
Seat 6: FakaN4Kavera folded before Flop (didn't bet)



PokerStars Zoom Hand #257880063252:  Hold'em No Limit ($0.02/$0.05) - 2025/09/25 19:45:45 JST [2025/09/25 6:45:45 ET]
Table 'Donati' 6-max Seat #1 is the button
Seat 1: scottie4barnes ($3.86 in chips) 
Seat 2: Kenzo2211 ($5.78 in chips) 
Seat 3: vlad.mdv ($4.16 in chips) 
Seat 4: FakaN4Kavera ($5.52 in chips) 
Seat 5: faithfulness ($5 in chips) 
Seat 6: tomis1312 ($5.52 in chips) 
Kenzo2211: posts small blind $0.02
vlad.mdv: posts big blind $0.05
*** HOLE CARDS ***
Dealt to FakaN4Kavera [7d Ac]
FakaN4Kavera: folds 
faithfulness: folds 
tomis1312: raises $0.05 to $0.10
scottie4barnes: folds 
Kenzo2211: folds 
vlad.mdv: calls $0.05
*** FLOP *** [9c 3c Qs]
vlad.mdv: checks 
tomis1312: bets $0.07
vlad.mdv: folds 
Uncalled bet ($0.07) returned to tomis1312
tomis1312 collected $0.21 from pot
tomis1312: doesn't show hand 
*** SUMMARY ***
Total pot $0.22 | Rake $0.01 
Board [9c 3c Qs]
Seat 1: scottie4barnes (button) folded before Flop (didn't bet)
Seat 2: Kenzo2211 (small blind) folded before Flop
Seat 3: vlad.mdv (big blind) folded on the Flop
Seat 4: FakaN4Kavera folded before Flop (didn't bet)
Seat 5: faithfulness folded before Flop (didn't bet)
Seat 6: tomis1312 collected ($0.21)



PokerStars Zoom Hand #257880064944:  Hold'em No Limit ($0.02/$0.05) - 2025/09/25 19:46:01 JST [2025/09/25 6:46:01 ET]
Table 'Donati' 6-max Seat #1 is the button
Seat 1: FakaN4Kavera ($5.50 in chips) 
Seat 2: faithfulness ($5.02 in chips) 
Seat 3: Ingyeoking ($4.17 in chips) 
Seat 4: intentii ($5.30 in chips) 
Seat 5: 1Kronos ($14.06 in chips) 
Seat 6: YAG5292 ($12.05 in chips) 
faithfulness: posts small blind $0.02
Ingyeoking: posts big blind $0.05
*** HOLE CARDS ***
Dealt to FakaN4Kavera [Td Kc]
intentii: raises $0.08 to $0.13
1Kronos: folds 
YAG5292: folds 
FakaN4Kavera: folds 
faithfulness: folds 
Ingyeoking: folds 
Uncalled bet ($0.08) returned to intentii
intentii collected $0.12 from pot
intentii: doesn't show hand 
*** SUMMARY ***
Total pot $0.12 | Rake $0 
Seat 1: FakaN4Kavera (button) folded before Flop (didn't bet)
Seat 2: faithfulness (small blind) folded before Flop
Seat 3: Ingyeoking (big blind) folded before Flop
Seat 4: intentii collected ($0.12)
Seat 5: 1Kronos folded before Flop (didn't bet)
Seat 6: YAG5292 folded before Flop (didn't bet)



PokerStars Zoom Hand #257880064058:  Hold'em No Limit ($0.02/$0.05) - 2025/09/25 19:45:53 JST [2025/09/25 6:45:53 ET]
Table 'Donati' 6-max Seat #1 is the button
Seat 1: Ingyeoking ($10.89 in chips) 
Seat 2: FakaN4Kavera ($5.52 in chips) 
Seat 3: YAG5292 ($3.50 in chips) 
Seat 4: Megam181 ($3.47 in chips) 
Seat 5: Baikasas ($7.59 in chips) 
Seat 6: kmc4444 ($5 in chips) 
FakaN4Kavera: posts small blind $0.02
YAG5292: posts big blind $0.05
*** HOLE CARDS ***
Dealt to FakaN4Kavera [7h 3c]
Megam181: raises $0.15 to $0.20
Baikasas: folds 
kmc4444: folds 
Ingyeoking: folds 
FakaN4Kavera: folds 
YAG5292: folds 
Uncalled bet ($0.15) returned to Megam181
Megam181 collected $0.12 from pot
Megam181: doesn't show hand 
*** SUMMARY ***
Total pot $0.12 | Rake $0 
Seat 1: Ingyeoking (button) folded before Flop (didn't bet)
Seat 2: FakaN4Kavera (small blind) folded before Flop
Seat 3: YAG5292 (big blind) folded before Flop
Seat 4: Megam181 collected ($0.12)
Seat 5: Baikasas folded before Flop (didn't bet)
Seat 6: kmc4444 folded before Flop (didn't bet)



PokerStars Zoom Hand #257880066554:  Hold'em No Limit ($0.02/$0.05) - 2025/09/25 19:46:17 JST [2025/09/25 6:46:17 ET]
Table 'Donati' 6-max Seat #1 is the button
Seat 1: huyjokezy ($6.50 in chips) 
Seat 2: kmc4444 ($5 in chips) 
Seat 3: FakaN4Kavera ($5.50 in chips) 
Seat 4: Baikasas ($7.59 in chips) 
Seat 5: Irrubikajs ($5.58 in chips) 
Seat 6: Coco_bear373 ($11.56 in chips) 
kmc4444: posts small blind $0.02
FakaN4Kavera: posts big blind $0.05
*** HOLE CARDS ***
Dealt to FakaN4Kavera [8h 5d]
Baikasas: folds 
Irrubikajs: folds 
Coco_bear373: raises $0.07 to $0.12
huyjokezy: folds 
kmc4444: folds 
FakaN4Kavera: folds 
Uncalled bet ($0.07) returned to Coco_bear373
Coco_bear373 collected $0.12 from pot
Coco_bear373: doesn't show hand 
*** SUMMARY ***
Total pot $0.12 | Rake $0 
Seat 1: huyjokezy (button) folded before Flop (didn't bet)
Seat 2: kmc4444 (small blind) folded before Flop
Seat 3: FakaN4Kavera (big blind) folded before Flop
Seat 4: Baikasas folded before Flop (didn't bet)
Seat 5: Irrubikajs folded before Flop (didn't bet)
Seat 6: Coco_bear373 collected ($0.12)



PokerStars Zoom Hand #257880066164:  Hold'em No Limit ($0.02/$0.05) - 2025/09/25 19:46:13 JST [2025/09/25 6:46:13 ET]
Table 'Donati' 6-max Seat #1 is the button
Seat 1: Epist461 ($6.52 in chips) 
Seat 2: 1Kronos ($14.06 in chips) 
Seat 3: KRSofM ($4.93 in chips) 
Seat 4: Irrubikajs ($5.58 in chips) 
Seat 5: FakaN4Kavera ($5.50 in chips) 
Seat 6: goaßmaß-fips ($14.09 in chips) 
1Kronos: posts small blind $0.02
KRSofM: posts big blind $0.05
*** HOLE CARDS ***
Dealt to FakaN4Kavera [Qd 7c]
Irrubikajs: folds 
FakaN4Kavera: folds 
goaßmaß-fips: raises $0.10 to $0.15
Epist461: folds 
1Kronos: raises $0.40 to $0.55
KRSofM: folds 
goaßmaß-fips: raises $1.15 to $1.70
1Kronos: folds 
Uncalled bet ($1.15) returned to goaßmaß-fips
goaßmaß-fips collected $1.15 from pot
goaßmaß-fips: doesn't show hand 
*** SUMMARY ***
Total pot $1.15 | Rake $0 
Seat 1: Epist461 (button) folded before Flop (didn't bet)
Seat 2: 1Kronos (small blind) folded before Flop
Seat 3: KRSofM (big blind) folded before Flop
Seat 4: Irrubikajs folded before Flop (didn't bet)
Seat 5: FakaN4Kavera folded before Flop (didn't bet)
Seat 6: goaßmaß-fips collected ($1.15)



PokerStars Zoom Hand #257880062723:  Hold'em No Limit ($0.02/$0.05) - 2025/09/25 19:45:40 JST [2025/09/25 6:45:40 ET]
Table 'Donati' 6-max Seat #1 is the button
Seat 1: franks270 ($12.26 in chips) 
Seat 2: Epist461 ($6.82 in chips) 
Seat 3: leakleakA ($11.78 in chips) 
Seat 4: faithfulness ($5 in chips) 
Seat 5: FakaN4Kavera ($5.52 in chips) 
Seat 6: Kenzo2211 ($5.78 in chips) 
Epist461: posts small blind $0.02
leakleakA: posts big blind $0.05
*** HOLE CARDS ***
Dealt to FakaN4Kavera [5d Qh]
faithfulness: folds 
FakaN4Kavera: folds 
Kenzo2211: folds 
franks270: raises $0.10 to $0.15
Epist461: folds 
leakleakA: calls $0.10
*** FLOP *** [8d 3h Kc]
leakleakA: checks 
franks270: bets $0.05
leakleakA: calls $0.05
*** TURN *** [8d 3h Kc] [4c]
leakleakA: checks 
franks270: bets $0.20
leakleakA: calls $0.20
*** RIVER *** [8d 3h Kc 4c] [9h]
leakleakA: checks 
franks270: bets $0.79
leakleakA: calls $0.79
*** SHOW DOWN ***
franks270: shows [8h 8c] (three of a kind, Eights)
leakleakA: mucks hand 
franks270 collected $2.30 from pot
*** SUMMARY ***
Total pot $2.40 | Rake $0.10 
Board [8d 3h Kc 4c 9h]
Seat 1: franks270 (button) showed [8h 8c] and won ($2.30) with three of a kind, Eights
Seat 2: Epist461 (small blind) folded before Flop
Seat 3: leakleakA (big blind) mucked [Qs 8s]
Seat 4: faithfulness folded before Flop (didn't bet)
Seat 5: FakaN4Kavera folded before Flop (didn't bet)
Seat 6: Kenzo2211 folded before Flop (didn't bet)



PokerStars Zoom Hand #257880069309:  Hold'em No Limit ($0.02/$0.05) - 2025/09/25 19:46:43 JST [2025/09/25 6:46:43 ET]
Table 'Donati' 6-max Seat #1 is the button
Seat 1: Ingyeoking ($10.82 in chips) 
Seat 2: tomis1312 ($5.48 in chips) 
Seat 3: St4ut ($5 in chips) 
Seat 4: klevinjer ($5.71 in chips) 
Seat 5: sepik200 ($4.75 in chips) 
Seat 6: FakaN4Kavera ($5.45 in chips) 
tomis1312: posts small blind $0.02
St4ut: posts big blind $0.05
*** HOLE CARDS ***
Dealt to FakaN4Kavera [4s 2s]
klevinjer: folds 
sepik200: raises $0.12 to $0.17
FakaN4Kavera: folds 
Ingyeoking: folds 
tomis1312: folds 
St4ut: folds 
Uncalled bet ($0.12) returned to sepik200
sepik200 collected $0.12 from pot
sepik200: doesn't show hand 
*** SUMMARY ***
Total pot $0.12 | Rake $0 
Seat 1: Ingyeoking (button) folded before Flop (didn't bet)
Seat 2: tomis1312 (small blind) folded before Flop
Seat 3: St4ut (big blind) folded before Flop
Seat 4: klevinjer folded before Flop (didn't bet)
Seat 5: sepik200 collected ($0.12)
Seat 6: FakaN4Kavera folded before Flop (didn't bet)



PokerStars Zoom Hand #257880069742:  Hold'em No Limit ($0.02/$0.05) - 2025/09/25 19:46:47 JST [2025/09/25 6:46:47 ET]
Table 'Donati' 6-max Seat #1 is the button
Seat 1: 1Kronos ($13.51 in chips) 
Seat 2: Schöngeist71 ($12.49 in chips) 
Seat 3: klevinjer ($5.71 in chips) 
Seat 4: FakaN4Kavera ($5.45 in chips) 
Seat 5: Epist461 ($6.73 in chips) 
Seat 6: YAG5292 ($3.24 in chips) 
Schöngeist71: posts small blind $0.02
klevinjer: posts big blind $0.05
*** HOLE CARDS ***
Dealt to FakaN4Kavera [9s 9d]
FakaN4Kavera: raises $0.07 to $0.12
Epist461: folds 
YAG5292: folds 
1Kronos: folds 
Schöngeist71: folds 
klevinjer: calls $0.07
*** FLOP *** [2s Qs Jc]
klevinjer: checks 
FakaN4Kavera: checks 
*** TURN *** [2s Qs Jc] [5h]
klevinjer: bets $0.13
FakaN4Kavera: folds 
Uncalled bet ($0.13) returned to klevinjer
klevinjer collected $0.25 from pot
klevinjer: doesn't show hand 
*** SUMMARY ***
Total pot $0.26 | Rake $0.01 
Board [2s Qs Jc 5h]
Seat 1: 1Kronos (button) folded before Flop (didn't bet)
Seat 2: Schöngeist71 (small blind) folded before Flop
Seat 3: klevinjer (big blind) collected ($0.25)
Seat 4: FakaN4Kavera folded on the Turn
Seat 5: Epist461 folded before Flop (didn't bet)
Seat 6: YAG5292 folded before Flop (didn't bet)



PokerStars Zoom Hand #257880072858:  Hold'em No Limit ($0.02/$0.05) - 2025/09/25 19:47:17 JST [2025/09/25 6:47:17 ET]
Table 'Donati' 6-max Seat #1 is the button
Seat 1: FakaN4Kavera ($5.31 in chips) 
Seat 2: zodapoker ($7.13 in chips) 
Seat 3: 1Kronos ($13.51 in chips) 
Seat 4: Coco_bear373 ($11.65 in chips) 
Seat 5: Kenzo2211 ($5.24 in chips) 
Seat 6: Ingyeoking ($5.62 in chips) 
zodapoker: posts small blind $0.02
1Kronos: posts big blind $0.05
*** HOLE CARDS ***
Dealt to FakaN4Kavera [6c Th]
Coco_bear373: folds 
Kenzo2211: folds 
Ingyeoking: folds 
FakaN4Kavera: folds 
zodapoker: folds 
Uncalled bet ($0.03) returned to 1Kronos
1Kronos collected $0.04 from pot
1Kronos: doesn't show hand 
*** SUMMARY ***
Total pot $0.04 | Rake $0 
Seat 1: FakaN4Kavera (button) folded before Flop (didn't bet)
Seat 2: zodapoker (small blind) folded before Flop
Seat 3: 1Kronos (big blind) collected ($0.04)
Seat 4: Coco_bear373 folded before Flop (didn't bet)
Seat 5: Kenzo2211 folded before Flop (didn't bet)
Seat 6: Ingyeoking folded before Flop (didn't bet)



PokerStars Zoom Hand #257880072199:  Hold'em No Limit ($0.02/$0.05) - 2025/09/25 19:47:11 JST [2025/09/25 6:47:11 ET]
Table 'Donati' 6-max Seat #1 is the button
Seat 1: KRSofM ($4.79 in chips) 
Seat 2: FakaN4Kavera ($5.33 in chips) 
Seat 3: YAG5292 ($7.26 in chips) 
Seat 4: IBRODIAN-ACER ($5 in chips) 
Seat 5: egoor199 ($5.55 in chips) 
Seat 6: kmc4444 ($5 in chips) 
FakaN4Kavera: posts small blind $0.02
YAG5292: posts big blind $0.05
*** HOLE CARDS ***
Dealt to FakaN4Kavera [9h 6d]
IBRODIAN-ACER: folds 
egoor199: folds 
kmc4444: raises $0.07 to $0.12
KRSofM: folds 
FakaN4Kavera: folds 
YAG5292: folds 
Uncalled bet ($0.07) returned to kmc4444
kmc4444 collected $0.12 from pot
kmc4444: doesn't show hand 
*** SUMMARY ***
Total pot $0.12 | Rake $0 
Seat 1: KRSofM (button) folded before Flop (didn't bet)
Seat 2: FakaN4Kavera (small blind) folded before Flop
Seat 3: YAG5292 (big blind) folded before Flop
Seat 4: IBRODIAN-ACER folded before Flop (didn't bet)
Seat 5: egoor199 folded before Flop (didn't bet)
Seat 6: kmc4444 collected ($0.12)



PokerStars Zoom Hand #257880074008:  Hold'em No Limit ($0.02/$0.05) - 2025/09/25 19:47:29 JST [2025/09/25 6:47:29 ET]
Table 'Donati' 6-max Seat #1 is the button
Seat 1: Baikasas ($5.10 in chips) 
Seat 2: vlad.mdv ($2.84 in chips) 
Seat 3: Kenbunshoku ($11.72 in chips) 
Seat 4: Kenzo2211 ($5.76 in chips) 
Seat 5: FakaN4Kavera ($5.31 in chips) 
Seat 6: tomis1312 ($5.46 in chips) 
vlad.mdv: posts small blind $0.02
Kenbunshoku: posts big blind $0.05
*** HOLE CARDS ***
Dealt to FakaN4Kavera [7s 5s]
Kenzo2211: folds 
FakaN4Kavera: folds 
tomis1312: folds 
Baikasas: folds 
vlad.mdv: folds 
Uncalled bet ($0.03) returned to Kenbunshoku
Kenbunshoku collected $0.04 from pot
Kenbunshoku: doesn't show hand 
*** SUMMARY ***
Total pot $0.04 | Rake $0 
Seat 1: Baikasas (button) folded before Flop (didn't bet)
Seat 2: vlad.mdv (small blind) folded before Flop
Seat 3: Kenbunshoku (big blind) collected ($0.04)
Seat 4: Kenzo2211 folded before Flop (didn't bet)
Seat 5: FakaN4Kavera folded before Flop (didn't bet)
Seat 6: tomis1312 folded before Flop (didn't bet)



PokerStars Zoom Hand #257880074631:  Hold'em No Limit ($0.02/$0.05) - 2025/09/25 19:47:35 JST [2025/09/25 6:47:35 ET]
Table 'Donati' 6-max Seat #1 is the button
Seat 1: KRSofM ($5.04 in chips) 
Seat 2: Ingyeoking ($5.62 in chips) 
Seat 3: semmely ($9.93 in chips) 
Seat 4: FakaN4Kavera ($5.31 in chips) 
Seat 5: Baikasas ($5.10 in chips) 
Seat 6: faithfulness ($5.09 in chips) 
Ingyeoking: posts small blind $0.02
semmely: posts big blind $0.05
*** HOLE CARDS ***
Dealt to FakaN4Kavera [2h 7c]
FakaN4Kavera: folds 
Baikasas: folds 
faithfulness: folds 
KRSofM: folds 
Ingyeoking: folds 
Uncalled bet ($0.03) returned to semmely
semmely collected $0.04 from pot
semmely: doesn't show hand 
*** SUMMARY ***
Total pot $0.04 | Rake $0 
Seat 1: KRSofM (button) folded before Flop (didn't bet)
Seat 2: Ingyeoking (small blind) folded before Flop
Seat 3: semmely (big blind) collected ($0.04)
Seat 4: FakaN4Kavera folded before Flop (didn't bet)
Seat 5: Baikasas folded before Flop (didn't bet)
Seat 6: faithfulness folded before Flop (didn't bet)



PokerStars Zoom Hand #257880075055:  Hold'em No Limit ($0.02/$0.05) - 2025/09/25 19:47:38 JST [2025/09/25 6:47:38 ET]
Table 'Donati' 6-max Seat #1 is the button
Seat 1: Ingyeoking ($5.77 in chips) 
Seat 2: FakaN4Kavera ($5.31 in chips) 
Seat 3: Epist461 ($6.63 in chips) 
Seat 4: YAG5292 ($3.07 in chips) 
Seat 5: skygger777 ($4.24 in chips) 
Seat 6: tomis1312 ($5.46 in chips) 
FakaN4Kavera: posts small blind $0.02
Epist461: posts big blind $0.05
*** HOLE CARDS ***
Dealt to FakaN4Kavera [Qc Kc]
YAG5292: raises $0.09 to $0.14
skygger777: calls $0.14
tomis1312: raises $0.36 to $0.50
Ingyeoking: folds 
FakaN4Kavera: folds 
Epist461: folds 
YAG5292: folds 
skygger777: calls $0.36
*** FLOP *** [8d 3d 3s]
skygger777: checks 
tomis1312: bets $0.38
skygger777: folds 
Uncalled bet ($0.38) returned to tomis1312
tomis1312 collected $1.16 from pot
tomis1312: doesn't show hand 
*** SUMMARY ***
Total pot $1.21 | Rake $0.05 
Board [8d 3d 3s]
Seat 1: Ingyeoking (button) folded before Flop (didn't bet)
Seat 2: FakaN4Kavera (small blind) folded before Flop
Seat 3: Epist461 (big blind) folded before Flop
Seat 4: YAG5292 folded before Flop
Seat 5: skygger777 folded on the Flop
Seat 6: tomis1312 collected ($1.16)



PokerStars Zoom Hand #257880073268:  Hold'em No Limit ($0.02/$0.05) - 2025/09/25 19:47:21 JST [2025/09/25 6:47:21 ET]
Table 'Donati' 6-max Seat #1 is the button
Seat 1: tomis1312 ($5.46 in chips) 
Seat 2: IBRODIAN-ACER ($5 in chips) 
Seat 3: faithfulness ($5.13 in chips) 
Seat 4: Ingyeoking ($5.62 in chips) 
Seat 5: elmex886 ($5 in chips) 
Seat 6: FakaN4Kavera ($5.31 in chips) 
IBRODIAN-ACER: posts small blind $0.02
faithfulness: posts big blind $0.05
*** HOLE CARDS ***
Dealt to FakaN4Kavera [8c Kd]
Ingyeoking: folds 
elmex886: raises $0.10 to $0.15
FakaN4Kavera: folds 
tomis1312: folds 
IBRODIAN-ACER: calls $0.13
faithfulness: raises $0.59 to $0.74
elmex886: calls $0.59
IBRODIAN-ACER: folds 
*** FLOP *** [3h 8h 2s]
faithfulness: bets $0.52
elmex886: calls $0.52
*** TURN *** [3h 8h 2s] [5c]
faithfulness: checks 
elmex886: bets $0.84
faithfulness: raises $3.03 to $3.87 and is all-in
elmex886: folds 
Uncalled bet ($3.03) returned to faithfulness
faithfulness collected $4.17 from pot
faithfulness: doesn't show hand 
*** SUMMARY ***
Total pot $4.35 | Rake $0.18 
Board [3h 8h 2s 5c]
Seat 1: tomis1312 (button) folded before Flop (didn't bet)
Seat 2: IBRODIAN-ACER (small blind) folded before Flop
Seat 3: faithfulness (big blind) collected ($4.17)
Seat 4: Ingyeoking folded before Flop (didn't bet)
Seat 5: elmex886 folded on the Turn
Seat 6: FakaN4Kavera folded before Flop (didn't bet)



PokerStars Zoom Hand #257880080213:  Hold'em No Limit ($0.02/$0.05) - 2025/09/25 19:48:28 JST [2025/09/25 6:48:28 ET]
Table 'Donati' 6-max Seat #1 is the button
Seat 1: Megam181 ($5.96 in chips) 
Seat 2: zodapoker ($4.31 in chips) 
Seat 3: klevinjer ($5.59 in chips) 
Seat 4: FakaN4Kavera ($5.24 in chips) 
Seat 5: IBRODIAN-ACER ($5.16 in chips) 
Seat 6: KRSofM ($4.72 in chips) 
zodapoker: posts small blind $0.02
klevinjer: posts big blind $0.05
*** HOLE CARDS ***
Dealt to FakaN4Kavera [8d Tc]
FakaN4Kavera: folds 
IBRODIAN-ACER: folds 
KRSofM: folds 
Megam181: folds 
zodapoker: raises $0.07 to $0.12
klevinjer: folds 
Uncalled bet ($0.07) returned to zodapoker
zodapoker collected $0.10 from pot
zodapoker: doesn't show hand 
*** SUMMARY ***
Total pot $0.10 | Rake $0 
Seat 1: Megam181 (button) folded before Flop (didn't bet)
Seat 2: zodapoker (small blind) collected ($0.10)
Seat 3: klevinjer (big blind) folded before Flop
Seat 4: FakaN4Kavera folded before Flop (didn't bet)
Seat 5: IBRODIAN-ACER folded before Flop (didn't bet)
Seat 6: KRSofM folded before Flop (didn't bet)



PokerStars Zoom Hand #257880080535:  Hold'em No Limit ($0.02/$0.05) - 2025/09/25 19:48:31 JST [2025/09/25 6:48:31 ET]
Table 'Donati' 6-max Seat #1 is the button
Seat 1: tomis1312 ($6.07 in chips) 
Seat 2: KRSofM ($4.99 in chips) 
Seat 3: FakaN4Kavera ($5.24 in chips) 
Seat 4: Vasco4430 ($8.09 in chips) 
Seat 5: Ingyeoking ($10.88 in chips) 
Seat 6: YAG5292 ($2.93 in chips) 
KRSofM: posts small blind $0.02
FakaN4Kavera: posts big blind $0.05
*** HOLE CARDS ***
Dealt to FakaN4Kavera [8h 5c]
Vasco4430 has timed out
Vasco4430: folds 
Ingyeoking: folds 
YAG5292: folds 
tomis1312: folds 
KRSofM: folds 
Uncalled bet ($0.03) returned to FakaN4Kavera
FakaN4Kavera collected $0.04 from pot
FakaN4Kavera: doesn't show hand 
*** SUMMARY ***
Total pot $0.04 | Rake $0 
Seat 1: tomis1312 (button) folded before Flop (didn't bet)
Seat 2: KRSofM (small blind) folded before Flop
Seat 3: FakaN4Kavera (big blind) collected ($0.04)
Seat 4: Vasco4430 folded before Flop (didn't bet)
Seat 5: Ingyeoking folded before Flop (didn't bet)
Seat 6: YAG5292 folded before Flop (didn't bet)



PokerStars Zoom Hand #257880078541:  Hold'em No Limit ($0.02/$0.05) - 2025/09/25 19:48:12 JST [2025/09/25 6:48:12 ET]
Table 'Donati' 6-max Seat #1 is the button
Seat 1: elmex886 ($5 in chips) 
Seat 2: lebifflemaster ($7.98 in chips) 
Seat 3: FakaN4Kavera ($5.29 in chips) 
Seat 4: tomis1312 ($6.12 in chips) 
Seat 5: Kenzo2211 ($5.24 in chips) 
Seat 6: KRSofM ($4.98 in chips) 
lebifflemaster: posts small blind $0.02
FakaN4Kavera: posts big blind $0.05
*** HOLE CARDS ***
Dealt to FakaN4Kavera [Qc 8h]
tomis1312: folds 
Kenzo2211: folds 
KRSofM: folds 
elmex886: raises $0.10 to $0.15
lebifflemaster: raises $0.55 to $0.70
FakaN4Kavera: folds 
elmex886: calls $0.55
*** FLOP *** [6d Ad Jd]
lebifflemaster: bets $0.46
elmex886: calls $0.46
*** TURN *** [6d Ad Jd] [3h]
lebifflemaster: checks 
elmex886: bets $0.75
lebifflemaster: folds 
Uncalled bet ($0.75) returned to elmex886
elmex886 collected $2.27 from pot
elmex886: doesn't show hand 
*** SUMMARY ***
Total pot $2.37 | Rake $0.10 
Board [6d Ad Jd 3h]
Seat 1: elmex886 (button) collected ($2.27)
Seat 2: lebifflemaster (small blind) folded on the Turn
Seat 3: FakaN4Kavera (big blind) folded before Flop
Seat 4: tomis1312 folded before Flop (didn't bet)
Seat 5: Kenzo2211 folded before Flop (didn't bet)
Seat 6: KRSofM folded before Flop (didn't bet)



PokerStars Zoom Hand #257880083650:  Hold'em No Limit ($0.02/$0.05) - 2025/09/25 19:49:01 JST [2025/09/25 6:49:01 ET]
Table 'Donati' 6-max Seat #1 is the button
Seat 1: skygger777 ($4.35 in chips) 
Seat 2: FakaN4Kavera ($5.26 in chips) 
Seat 3: intentii ($5.35 in chips) 
Seat 4: KRSofM ($4.97 in chips) 
Seat 5: Epist461 ($6.49 in chips) 
Seat 6: 1Kronos ($5 in chips) 
FakaN4Kavera: posts small blind $0.02
intentii: posts big blind $0.05
*** HOLE CARDS ***
Dealt to FakaN4Kavera [9c Jd]
KRSofM: folds 
Epist461: folds 
1Kronos: folds 
skygger777: folds 
FakaN4Kavera: folds 
Uncalled bet ($0.03) returned to intentii
intentii collected $0.04 from pot
intentii: doesn't show hand 
*** SUMMARY ***
Total pot $0.04 | Rake $0 
Seat 1: skygger777 (button) folded before Flop (didn't bet)
Seat 2: FakaN4Kavera (small blind) folded before Flop
Seat 3: intentii (big blind) collected ($0.04)
Seat 4: KRSofM folded before Flop (didn't bet)
Seat 5: Epist461 folded before Flop (didn't bet)
Seat 6: 1Kronos folded before Flop (didn't bet)



PokerStars Zoom Hand #257880082300:  Hold'em No Limit ($0.02/$0.05) - 2025/09/25 19:48:48 JST [2025/09/25 6:48:48 ET]
Table 'Donati' 6-max Seat #1 is the button
Seat 1: zodapoker ($4.36 in chips) 
Seat 2: goaßmaß-fips ($14.81 in chips) 
Seat 3: 1Kronos ($5 in chips) 
Seat 4: sepik200 ($5.05 in chips) 
Seat 5: KRSofM ($4.97 in chips) 
Seat 6: FakaN4Kavera ($5.26 in chips) 
goaßmaß-fips: posts small blind $0.02
1Kronos: posts big blind $0.05
*** HOLE CARDS ***
Dealt to FakaN4Kavera [7c Kc]
sepik200: folds 
KRSofM: folds 
FakaN4Kavera: folds 
zodapoker: raises $0.07 to $0.12
goaßmaß-fips: raises $0.36 to $0.48
1Kronos: folds 
zodapoker: folds 
Uncalled bet ($0.36) returned to goaßmaß-fips
goaßmaß-fips collected $0.29 from pot
goaßmaß-fips: doesn't show hand 
*** SUMMARY ***
Total pot $0.29 | Rake $0 
Seat 1: zodapoker (button) folded before Flop
Seat 2: goaßmaß-fips (small blind) collected ($0.29)
Seat 3: 1Kronos (big blind) folded before Flop
Seat 4: sepik200 folded before Flop (didn't bet)
Seat 5: KRSofM folded before Flop (didn't bet)
Seat 6: FakaN4Kavera folded before Flop (didn't bet)



PokerStars Zoom Hand #257880083226:  Hold'em No Limit ($0.02/$0.05) - 2025/09/25 19:48:57 JST [2025/09/25 6:48:57 ET]
Table 'Donati' 6-max Seat #1 is the button
Seat 1: egoor199 ($5.48 in chips) 
Seat 2: Ingyeoking ($5.28 in chips) 
Seat 3: klevinjer ($5.52 in chips) 
Seat 4: sepik200 ($5.05 in chips) 
Seat 5: FakaN4Kavera ($5.26 in chips) 
Seat 6: Kenzo2211 ($5.95 in chips) 
Ingyeoking: posts small blind $0.02
klevinjer: posts big blind $0.05
*** HOLE CARDS ***
Dealt to FakaN4Kavera [Tc 7d]
sepik200: folds 
FakaN4Kavera: folds 
Kenzo2211: folds 
egoor199: folds 
Ingyeoking: raises $0.10 to $0.15
klevinjer: folds 
Uncalled bet ($0.10) returned to Ingyeoking
Ingyeoking collected $0.10 from pot
Ingyeoking: doesn't show hand 
*** SUMMARY ***
Total pot $0.10 | Rake $0 
Seat 1: egoor199 (button) folded before Flop (didn't bet)
Seat 2: Ingyeoking (small blind) collected ($0.10)
Seat 3: klevinjer (big blind) folded before Flop
Seat 4: sepik200 folded before Flop (didn't bet)
Seat 5: FakaN4Kavera folded before Flop (didn't bet)
Seat 6: Kenzo2211 folded before Flop (didn't bet)



PokerStars Zoom Hand #257880084151:  Hold'em No Limit ($0.02/$0.05) - 2025/09/25 19:49:06 JST [2025/09/25 6:49:06 ET]
Table 'Donati' 6-max Seat #1 is the button
Seat 1: Epist461 ($6.49 in chips) 
Seat 2: 1Kronos ($5 in chips) 
Seat 3: Baikasas ($10.23 in chips) 
Seat 4: FakaN4Kavera ($5.24 in chips) 
Seat 5: vlad.mdv ($2.77 in chips) 
Seat 6: skygger777 ($4.35 in chips) 
1Kronos: posts small blind $0.02
Baikasas: posts big blind $0.05
*** HOLE CARDS ***
Dealt to FakaN4Kavera [Td 6d]
FakaN4Kavera: folds 
vlad.mdv: folds 
skygger777: folds 
Epist461: raises $0.07 to $0.12
1Kronos: folds 
Baikasas: folds 
Uncalled bet ($0.07) returned to Epist461
Epist461 collected $0.12 from pot
Epist461: doesn't show hand 
*** SUMMARY ***
Total pot $0.12 | Rake $0 
Seat 1: Epist461 (button) collected ($0.12)
Seat 2: 1Kronos (small blind) folded before Flop
Seat 3: Baikasas (big blind) folded before Flop
Seat 4: FakaN4Kavera folded before Flop (didn't bet)
Seat 5: vlad.mdv folded before Flop (didn't bet)
Seat 6: skygger777 folded before Flop (didn't bet)



PokerStars Zoom Hand #257880079722:  Hold'em No Limit ($0.02/$0.05) - 2025/09/25 19:48:23 JST [2025/09/25 6:48:23 ET]
Table 'Donati' 6-max Seat #1 is the button
Seat 1: FakaN4Kavera ($5.24 in chips) 
Seat 2: kmc4444 ($5.37 in chips) 
Seat 3: faithfulness ($5 in chips) 
Seat 4: klevinjer ($5.59 in chips) 
Seat 5: Ingyeoking ($5.70 in chips) 
Seat 6: VXNX$157 ($2.78 in chips) 
kmc4444: posts small blind $0.02
faithfulness: posts big blind $0.05
*** HOLE CARDS ***
Dealt to FakaN4Kavera [5h Kd]
klevinjer: folds 
Ingyeoking: folds 
VXNX$157: folds 
FakaN4Kavera: folds 
kmc4444: raises $0.10 to $0.15
faithfulness: calls $0.10
*** FLOP *** [Qs Ts 3h]
kmc4444: checks 
faithfulness: checks 
*** TURN *** [Qs Ts 3h] [2h]
kmc4444: checks 
faithfulness: bets $0.22
kmc4444: folds 
Uncalled bet ($0.22) returned to faithfulness
faithfulness collected $0.29 from pot
faithfulness: doesn't show hand 
*** SUMMARY ***
Total pot $0.30 | Rake $0.01 
Board [Qs Ts 3h 2h]
Seat 1: FakaN4Kavera (button) folded before Flop (didn't bet)
Seat 2: kmc4444 (small blind) folded on the Turn
Seat 3: faithfulness (big blind) collected ($0.29)
Seat 4: klevinjer folded before Flop (didn't bet)
Seat 5: Ingyeoking folded before Flop (didn't bet)
Seat 6: VXNX$157 folded before Flop (didn't bet)



PokerStars Zoom Hand #257880084827:  Hold'em No Limit ($0.02/$0.05) - 2025/09/25 19:49:12 JST [2025/09/25 6:49:12 ET]
Table 'Donati' 6-max Seat #1 is the button
Seat 1: FakaN4Kavera ($5.24 in chips) 
Seat 2: kmc4444 ($5 in chips) 
Seat 3: KRSofM ($4.97 in chips) 
Seat 4: YAG5292 ($9.60 in chips) 
Seat 5: IBRODIAN-ACER ($5.73 in chips) 
Seat 6: Baikasas ($5 in chips) 
kmc4444: posts small blind $0.02
KRSofM: posts big blind $0.05
*** HOLE CARDS ***
Dealt to FakaN4Kavera [Kc 4c]
YAG5292: folds 
IBRODIAN-ACER: calls $0.05
Baikasas: folds 
FakaN4Kavera: folds 
kmc4444: folds 
KRSofM: raises $0.15 to $0.20
IBRODIAN-ACER: folds 
Uncalled bet ($0.15) returned to KRSofM
KRSofM collected $0.12 from pot
KRSofM: doesn't show hand 
*** SUMMARY ***
Total pot $0.12 | Rake $0 
Seat 1: FakaN4Kavera (button) folded before Flop (didn't bet)
Seat 2: kmc4444 (small blind) folded before Flop
Seat 3: KRSofM (big blind) collected ($0.12)
Seat 4: YAG5292 folded before Flop (didn't bet)
Seat 5: IBRODIAN-ACER folded before Flop
Seat 6: Baikasas folded before Flop (didn't bet)



PokerStars Zoom Hand #257880087402:  Hold'em No Limit ($0.02/$0.05) - 2025/09/25 19:49:37 JST [2025/09/25 6:49:37 ET]
Table 'Donati' 6-max Seat #1 is the button
Seat 1: YAG5292 ($9.55 in chips) 
Seat 2: faithfulness ($5 in chips) 
Seat 3: FakaN4Kavera ($5.24 in chips) 
Seat 4: Coco_bear373 ($10.86 in chips) 
Seat 5: klevinjer ($5.45 in chips) 
Seat 6: Tartarobass ($5 in chips) 
faithfulness: posts small blind $0.02
FakaN4Kavera: posts big blind $0.05
*** HOLE CARDS ***
Dealt to FakaN4Kavera [Qc Ts]
Coco_bear373: folds 
klevinjer: raises $0.07 to $0.12
Tartarobass: folds 
YAG5292: folds 
faithfulness: folds 
FakaN4Kavera: folds 
Uncalled bet ($0.07) returned to klevinjer
klevinjer collected $0.12 from pot
klevinjer: doesn't show hand 
*** SUMMARY ***
Total pot $0.12 | Rake $0 
Seat 1: YAG5292 (button) folded before Flop (didn't bet)
Seat 2: faithfulness (small blind) folded before Flop
Seat 3: FakaN4Kavera (big blind) folded before Flop
Seat 4: Coco_bear373 folded before Flop (didn't bet)
Seat 5: klevinjer collected ($0.12)
Seat 6: Tartarobass folded before Flop (didn't bet)



PokerStars Zoom Hand #257880088526:  Hold'em No Limit ($0.02/$0.05) - 2025/09/25 19:49:48 JST [2025/09/25 6:49:48 ET]
Table 'Donati' 6-max Seat #1 is the button
Seat 1: YAG5292 ($4.01 in chips) 
Seat 2: FakaN4Kavera ($5.19 in chips) 
Seat 3: Ingyeoking ($5.68 in chips) 
Seat 4: Kenzo2211 ($5.17 in chips) 
Seat 5: Schöngeist71 ($12.82 in chips) 
Seat 6: IBRODIAN-ACER ($5.70 in chips) 
FakaN4Kavera: posts small blind $0.02
Ingyeoking: posts big blind $0.05
*** HOLE CARDS ***
Dealt to FakaN4Kavera [8h 4c]
Kenzo2211: folds 
Schöngeist71: folds 
IBRODIAN-ACER: folds 
YAG5292: folds 
FakaN4Kavera: folds 
Uncalled bet ($0.03) returned to Ingyeoking
Ingyeoking collected $0.04 from pot
Ingyeoking: doesn't show hand 
*** SUMMARY ***
Total pot $0.04 | Rake $0 
Seat 1: YAG5292 (button) folded before Flop (didn't bet)
Seat 2: FakaN4Kavera (small blind) folded before Flop
Seat 3: Ingyeoking (big blind) collected ($0.04)
Seat 4: Kenzo2211 folded before Flop (didn't bet)
Seat 5: Schöngeist71 folded before Flop (didn't bet)
Seat 6: IBRODIAN-ACER folded before Flop (didn't bet)



PokerStars Zoom Hand #257880086785:  Hold'em No Limit ($0.02/$0.05) - 2025/09/25 19:49:31 JST [2025/09/25 6:49:31 ET]
Table 'Donati' 6-max Seat #1 is the button
Seat 1: kmc4444 ($5 in chips) 
Seat 2: intentii ($5.55 in chips) 
Seat 3: Epist461 ($6.56 in chips) 
Seat 4: tomis1312 ($5.98 in chips) 
Seat 5: VXNX$157 ($2.78 in chips) 
Seat 6: FakaN4Kavera ($5.24 in chips) 
intentii: posts small blind $0.02
Epist461: posts big blind $0.05
*** HOLE CARDS ***
Dealt to FakaN4Kavera [Tc 8h]
tomis1312: folds 
VXNX$157: raises $0.05 to $0.10
FakaN4Kavera: folds 
kmc4444: folds 
intentii: raises $0.36 to $0.46
Epist461: folds 
VXNX$157: folds 
Uncalled bet ($0.36) returned to intentii
intentii collected $0.25 from pot
intentii: doesn't show hand 
*** SUMMARY ***
Total pot $0.25 | Rake $0 
Seat 1: kmc4444 (button) folded before Flop (didn't bet)
Seat 2: intentii (small blind) collected ($0.25)
Seat 3: Epist461 (big blind) folded before Flop
Seat 4: tomis1312 folded before Flop (didn't bet)
Seat 5: VXNX$157 folded before Flop
Seat 6: FakaN4Kavera folded before Flop (didn't bet)



PokerStars Zoom Hand #257880088830:  Hold'em No Limit ($0.02/$0.05) - 2025/09/25 19:49:51 JST [2025/09/25 6:49:51 ET]
Table 'Donati' 6-max Seat #1 is the button
Seat 1: Epist461 ($6.49 in chips) 
Seat 2: faithfulness ($5 in chips) 
Seat 3: tomis1312 ($5.98 in chips) 
Seat 4: elmex886 ($5.99 in chips) 
Seat 5: FakaN4Kavera ($5.17 in chips) 
Seat 6: KRSofM ($5.05 in chips) 
faithfulness: posts small blind $0.02
tomis1312: posts big blind $0.05
*** HOLE CARDS ***
Dealt to FakaN4Kavera [3d Kh]
elmex886: folds 
FakaN4Kavera: folds 
KRSofM: raises $0.07 to $0.12
Epist461: raises $0.28 to $0.40
faithfulness: folds 
tomis1312: folds 
KRSofM: folds 
Uncalled bet ($0.28) returned to Epist461
Epist461 collected $0.31 from pot
Epist461: doesn't show hand 
*** SUMMARY ***
Total pot $0.31 | Rake $0 
Seat 1: Epist461 (button) collected ($0.31)
Seat 2: faithfulness (small blind) folded before Flop
Seat 3: tomis1312 (big blind) folded before Flop
Seat 4: elmex886 folded before Flop (didn't bet)
Seat 5: FakaN4Kavera folded before Flop (didn't bet)
Seat 6: KRSofM folded before Flop



PokerStars Zoom Hand #257880089753:  Hold'em No Limit ($0.02/$0.05) - 2025/09/25 19:50:00 JST [2025/09/25 6:50:00 ET]
Table 'Donati' 6-max Seat #1 is the button
Seat 1: FakaN4Kavera ($5.17 in chips) 
Seat 2: Kenzo2211 ($6.04 in chips) 
Seat 3: lebifflemaster ($7.20 in chips) 
Seat 4: YAG5292 ($7.12 in chips) 
Seat 5: KRSofM ($5.02 in chips) 
Seat 6: Schöngeist71 ($12.82 in chips) 
Kenzo2211: posts small blind $0.02
lebifflemaster: posts big blind $0.05
*** HOLE CARDS ***
Dealt to FakaN4Kavera [Qs 5d]
YAG5292: folds 
KRSofM: folds 
Schöngeist71: raises $0.10 to $0.15
FakaN4Kavera: folds 
Kenzo2211: folds 
lebifflemaster: folds 
Uncalled bet ($0.10) returned to Schöngeist71
Schöngeist71 collected $0.12 from pot
Schöngeist71: doesn't show hand 
*** SUMMARY ***
Total pot $0.12 | Rake $0 
Seat 1: FakaN4Kavera (button) folded before Flop (didn't bet)
Seat 2: Kenzo2211 (small blind) folded before Flop
Seat 3: lebifflemaster (big blind) folded before Flop
Seat 4: YAG5292 folded before Flop (didn't bet)
Seat 5: KRSofM folded before Flop (didn't bet)
Seat 6: Schöngeist71 collected ($0.12)



PokerStars Zoom Hand #257880091132:  Hold'em No Limit ($0.02/$0.05) - 2025/09/25 19:50:13 JST [2025/09/25 6:50:13 ET]
Table 'Donati' 6-max Seat #1 is the button
Seat 1: Gogart87 ($5.21 in chips) 
Seat 2: taoo7878 ($3.60 in chips) 
Seat 3: Baikasas ($10.16 in chips) 
Seat 4: 1Kronos ($9.85 in chips) 
Seat 5: IBRODIAN-ACER ($5.10 in chips) 
Seat 6: FakaN4Kavera ($5.17 in chips) 
taoo7878: posts small blind $0.02
Baikasas: posts big blind $0.05
*** HOLE CARDS ***
Dealt to FakaN4Kavera [3d 4d]
1Kronos: folds 
IBRODIAN-ACER: folds 
FakaN4Kavera: folds 
Gogart87: raises $0.07 to $0.12
taoo7878: folds 
Baikasas: folds 
Uncalled bet ($0.07) returned to Gogart87
Gogart87 collected $0.12 from pot
Gogart87: doesn't show hand 
*** SUMMARY ***
Total pot $0.12 | Rake $0 
Seat 1: Gogart87 (button) collected ($0.12)
Seat 2: taoo7878 (small blind) folded before Flop
Seat 3: Baikasas (big blind) folded before Flop
Seat 4: 1Kronos folded before Flop (didn't bet)
Seat 5: IBRODIAN-ACER folded before Flop (didn't bet)
Seat 6: FakaN4Kavera folded before Flop (didn't bet)



PokerStars Zoom Hand #257880090310:  Hold'em No Limit ($0.02/$0.05) - 2025/09/25 19:50:05 JST [2025/09/25 6:50:05 ET]
Table 'Donati' 6-max Seat #1 is the button
Seat 1: Baikasas ($10.16 in chips) 
Seat 2: klevinjer ($5.47 in chips) 
Seat 3: copperfield ($2.87 in chips) 
Seat 4: St4ut ($5.46 in chips) 
Seat 5: FakaN4Kavera ($5.17 in chips) 
Seat 6: Kenzo2211 ($6.02 in chips) 
klevinjer: posts small blind $0.02
copperfield: posts big blind $0.05
*** HOLE CARDS ***
Dealt to FakaN4Kavera [Kh 3c]
St4ut: folds 
FakaN4Kavera: folds 
Kenzo2211: folds 
Baikasas: folds 
klevinjer: calls $0.03
copperfield: checks 
*** FLOP *** [6d Kc 5s]
klevinjer: bets $0.05
copperfield: calls $0.05
*** TURN *** [6d Kc 5s] [Th]
klevinjer: bets $0.05
copperfield: raises $0.29 to $0.34
klevinjer: calls $0.29
*** RIVER *** [6d Kc 5s Th] [Jd]
klevinjer: checks 
copperfield: bets $0.42
klevinjer: calls $0.42
*** SHOW DOWN ***
copperfield: shows [6h Td] (two pair, Tens and Sixes)
klevinjer: mucks hand 
copperfield collected $1.65 from pot
*** SUMMARY ***
Total pot $1.72 | Rake $0.07 
Board [6d Kc 5s Th Jd]
Seat 1: Baikasas (button) folded before Flop (didn't bet)
Seat 2: klevinjer (small blind) mucked [Ac Ah]
Seat 3: copperfield (big blind) showed [6h Td] and won ($1.65) with two pair, Tens and Sixes
Seat 4: St4ut folded before Flop (didn't bet)
Seat 5: FakaN4Kavera folded before Flop (didn't bet)
Seat 6: Kenzo2211 folded before Flop (didn't bet)



PokerStars Zoom Hand #257880092179:  Hold'em No Limit ($0.02/$0.05) - 2025/09/25 19:50:23 JST [2025/09/25 6:50:23 ET]
Table 'Donati' 6-max Seat #1 is the button
Seat 1: sk1bbz ($5 in chips) 
Seat 2: 1Kronos ($13.41 in chips) 
Seat 3: FakaN4Kavera ($5.17 in chips) 
Seat 4: muhaaa3000 ($3.09 in chips) 
Seat 5: skygger777 ($3.40 in chips) 
Seat 6: goaßmaß-fips ($14.76 in chips) 
1Kronos: posts small blind $0.02
FakaN4Kavera: posts big blind $0.05
*** HOLE CARDS ***
Dealt to FakaN4Kavera [5c 5d]
muhaaa3000: folds 
skygger777: folds 
goaßmaß-fips: folds 
sk1bbz: raises $0.10 to $0.15
1Kronos: folds 
FakaN4Kavera: calls $0.10
*** FLOP *** [Th As 3s]
FakaN4Kavera: checks 
sk1bbz: bets $0.16
FakaN4Kavera: folds 
Uncalled bet ($0.16) returned to sk1bbz
sk1bbz collected $0.31 from pot
sk1bbz: doesn't show hand 
*** SUMMARY ***
Total pot $0.32 | Rake $0.01 
Board [Th As 3s]
Seat 1: sk1bbz (button) collected ($0.31)
Seat 2: 1Kronos (small blind) folded before Flop
Seat 3: FakaN4Kavera (big blind) folded on the Flop
Seat 4: muhaaa3000 folded before Flop (didn't bet)
Seat 5: skygger777 folded before Flop (didn't bet)
Seat 6: goaßmaß-fips folded before Flop (didn't bet)



PokerStars Zoom Hand #257880095239:  Hold'em No Limit ($0.02/$0.05) - 2025/09/25 19:50:53 JST [2025/09/25 6:50:53 ET]
Table 'Donati' 6-max Seat #1 is the button
Seat 1: taoo7878 ($3.65 in chips) 
Seat 2: lebifflemaster ($5 in chips) 
Seat 3: KRSofM ($4.86 in chips) 
Seat 4: FakaN4Kavera ($5.02 in chips) 
Seat 5: dervoigt ($4.37 in chips) 
Seat 6: Gogart87 ($7.65 in chips) 
lebifflemaster: posts small blind $0.02
KRSofM: posts big blind $0.05
*** HOLE CARDS ***
Dealt to FakaN4Kavera [4s Kd]
FakaN4Kavera: folds 
dervoigt: folds 
Gogart87: raises $0.07 to $0.12
taoo7878: folds 
lebifflemaster: folds 
KRSofM: folds 
Uncalled bet ($0.07) returned to Gogart87
Gogart87 collected $0.12 from pot
Gogart87: doesn't show hand 
*** SUMMARY ***
Total pot $0.12 | Rake $0 
Seat 1: taoo7878 (button) folded before Flop (didn't bet)
Seat 2: lebifflemaster (small blind) folded before Flop
Seat 3: KRSofM (big blind) folded before Flop
Seat 4: FakaN4Kavera folded before Flop (didn't bet)
Seat 5: dervoigt folded before Flop (didn't bet)
Seat 6: Gogart87 collected ($0.12)



PokerStars Zoom Hand #257880095553:  Hold'em No Limit ($0.02/$0.05) - 2025/09/25 19:50:56 JST [2025/09/25 6:50:56 ET]
Table 'Donati' 6-max Seat #1 is the button
Seat 1: Ingyeoking ($11.72 in chips) 
Seat 2: 1Kronos ($9.80 in chips) 
Seat 3: lefra9 ($6.16 in chips) 
Seat 4: FakaN4Kavera ($5.02 in chips) 
Seat 5: sk1bbz ($5.16 in chips) 
Seat 6: Gogart87 ($6.43 in chips) 
1Kronos: posts small blind $0.02
lefra9: posts big blind $0.05
*** HOLE CARDS ***
Dealt to FakaN4Kavera [Th 5c]
FakaN4Kavera: folds 
sk1bbz: folds 
Gogart87: raises $0.07 to $0.12
Ingyeoking: folds 
1Kronos: folds 
lefra9: folds 
Uncalled bet ($0.07) returned to Gogart87
Gogart87 collected $0.12 from pot
Gogart87: doesn't show hand 
*** SUMMARY ***
Total pot $0.12 | Rake $0 
Seat 1: Ingyeoking (button) folded before Flop (didn't bet)
Seat 2: 1Kronos (small blind) folded before Flop
Seat 3: lefra9 (big blind) folded before Flop
Seat 4: FakaN4Kavera folded before Flop (didn't bet)
Seat 5: sk1bbz folded before Flop (didn't bet)
Seat 6: Gogart87 collected ($0.12)



PokerStars Zoom Hand #257880096099:  Hold'em No Limit ($0.02/$0.05) - 2025/09/25 19:51:01 JST [2025/09/25 6:51:01 ET]
Table 'Donati' 6-max Seat #1 is the button
Seat 1: faithfulness ($5.17 in chips) 
Seat 2: FakaN4Kavera ($5.02 in chips) 
Seat 3: intentii ($5.70 in chips) 
Seat 4: 1Kronos ($13.55 in chips) 
Seat 5: dervoigt ($4.37 in chips) 
Seat 6: KRSofM ($5.14 in chips) 
FakaN4Kavera: posts small blind $0.02
intentii: posts big blind $0.05
*** HOLE CARDS ***
Dealt to FakaN4Kavera [Ad Qc]
1Kronos: folds 
dervoigt: folds 
KRSofM: folds 
faithfulness: folds 
FakaN4Kavera: raises $0.07 to $0.12
intentii: folds 
Uncalled bet ($0.07) returned to FakaN4Kavera
FakaN4Kavera collected $0.10 from pot
FakaN4Kavera: doesn't show hand 
*** SUMMARY ***
Total pot $0.10 | Rake $0 
Seat 1: faithfulness (button) folded before Flop (didn't bet)
Seat 2: FakaN4Kavera (small blind) collected ($0.10)
Seat 3: intentii (big blind) folded before Flop
Seat 4: 1Kronos folded before Flop (didn't bet)
Seat 5: dervoigt folded before Flop (didn't bet)
Seat 6: KRSofM folded before Flop (didn't bet)



PokerStars Zoom Hand #257880098927:  Hold'em No Limit ($0.02/$0.05) - 2025/09/25 19:51:28 JST [2025/09/25 6:51:28 ET]
Table 'Donati' 6-max Seat #1 is the button
Seat 1: FakaN4Kavera ($5.07 in chips) 
Seat 2: KRSofM ($5.84 in chips) 
Seat 3: faithfulness ($5.12 in chips) 
Seat 4: kmc4444 ($5.58 in chips) 
Seat 5: sk1bbz ($5.12 in chips) 
Seat 6: IBRODIAN-ACER ($5.52 in chips) 
KRSofM: posts small blind $0.02
faithfulness: posts big blind $0.05
*** HOLE CARDS ***
Dealt to FakaN4Kavera [3s Qs]
kmc4444: folds 
sk1bbz: folds 
IBRODIAN-ACER: folds 
FakaN4Kavera: folds 
KRSofM: raises $0.10 to $0.15
faithfulness: folds 
Uncalled bet ($0.10) returned to KRSofM
KRSofM collected $0.10 from pot
KRSofM: doesn't show hand 
*** SUMMARY ***
Total pot $0.10 | Rake $0 
Seat 1: FakaN4Kavera (button) folded before Flop (didn't bet)
Seat 2: KRSofM (small blind) collected ($0.10)
Seat 3: faithfulness (big blind) folded before Flop
Seat 4: kmc4444 folded before Flop (didn't bet)
Seat 5: sk1bbz folded before Flop (didn't bet)
Seat 6: IBRODIAN-ACER folded before Flop (didn't bet)



PokerStars Zoom Hand #257880099328:  Hold'em No Limit ($0.02/$0.05) - 2025/09/25 19:51:32 JST [2025/09/25 6:51:32 ET]
Table 'Donati' 6-max Seat #1 is the button
Seat 1: IBRODIAN-ACER ($5.52 in chips) 
Seat 2: Baikasas ($5.26 in chips) 
Seat 3: sk1bbz ($5.12 in chips) 
Seat 4: Ingyeoking ($4.50 in chips) 
Seat 5: Coco_bear373 ($10.77 in chips) 
Seat 6: FakaN4Kavera ($5.07 in chips) 
Baikasas: posts small blind $0.02
sk1bbz: posts big blind $0.05
*** HOLE CARDS ***
Dealt to FakaN4Kavera [Ac Kh]
Ingyeoking: folds 
Coco_bear373: folds 
FakaN4Kavera: raises $0.07 to $0.12
IBRODIAN-ACER: folds 
Baikasas: raises $0.28 to $0.40
sk1bbz: folds 
FakaN4Kavera: raises $0.85 to $1.25
Baikasas: folds 
Uncalled bet ($0.85) returned to FakaN4Kavera
FakaN4Kavera collected $0.85 from pot
FakaN4Kavera: doesn't show hand 
*** SUMMARY ***
Total pot $0.85 | Rake $0 
Seat 1: IBRODIAN-ACER (button) folded before Flop (didn't bet)
Seat 2: Baikasas (small blind) folded before Flop
Seat 3: sk1bbz (big blind) folded before Flop
Seat 4: Ingyeoking folded before Flop (didn't bet)
Seat 5: Coco_bear373 folded before Flop (didn't bet)
Seat 6: FakaN4Kavera collected ($0.85)



